zaaww=安安稳稳
zarwy=安然无恙
zarss=黯然失色
zalqc=按劳取酬
zarss=黯然神伤
zaryl=傲然屹立
zarxh=黯然销魂
zarts=安如泰山
zermr=耳濡目染
zendz=婀娜多姿
zerxh=耳软心活
zlahm=柳暗花明
zlewg=劳而无功
zllmm=琳琅满目
znrxw=耐人寻味
znnkg=难能可贵
zrlyk=热泪盈眶
zllwj=寥寥无几
zlljz=淋漓尽致
zrlry=任劳任怨
zllfx=雷厉风行
zllwf=流连忘返
zllqm=来龙去脉
zlrcx=寥若晨星
zrrfz=忍辱负重
zrrzs=仁人志士
zllbs=恋恋不舍
zrrwx=任人唯贤
zrrwq=任人唯亲
zllzh=利令智昏
zrrqs=弱肉强食
znlss=逆来顺受
znnrh=泥牛入海
zllww=碌碌无为
zrldd=如临大敌
zrlge=如雷贯耳
zlltx=戮力同心
zrlsh=如狼似虎
zlrbs=冷若冰霜
zrnss=如鸟兽散
zabss=爱不释手
zabbd=按兵不动
zabbs=哀兵必胜
zrbfc=入不敷出
zlbjs=两败俱伤
zlbmm=厉兵秣马
znbke=怒不可遏
zlbkp=牢不可破
zlbwj=狼狈为奸
zlbss=乐不思蜀
zrbkd=锐不可当
zlbbk=狼狈不堪
zrbxs=日薄西山
zlbsy=路不拾遗
zlbst=狼奔豕突
zlbsz=老蚌生珠
zecmm=耳聪目明
zlczb=鳞次栉比
zrcjj=人才济济
zlcbp=乐此不疲
zrcbc=人才辈出
zrcrz=如痴如醉
zrcyz=如出一辙
zlcrf=冷嘲热讽
zlcmj=良辰美景
zlcnm=郎才女貌
zlcsf=屡次三番
zadcc=暗度陈仓
zldmy=灵丹妙药
zldbd=雷打不动
zldbc=漏洞百出
zldyz=老当益壮
zrdsz=人多势众
zrdss=人地生疏
zldzd=老调重弹
zldcf=立地成佛
zldtj=李代桃僵
zrdyh=如堕烟海
zodsl=藕断丝连
zafsj=安分守己
zahby=哀鸿遍野
zehps=饿虎扑食
zrhrt=如火如荼
zrhty=如虎添翼
zrfys=人浮于事
zlhcq=炉火纯青
zrhzb=如获至宝
znfxl=逆反心理
zrhgt=融会贯通
zlfcx=龙凤呈祥
zlffw=龙飞凤舞
zrhfg=荣华富贵
zlhet=落荒而逃
zrhsj=如花似锦
znfcg=怒发冲冠
znhna=男欢女爱
zrhss=惹火烧身
znhrc=拈花惹草
zegmy=恶贯满盈
zngqj=能工巧匠
zlgjy=立竿见影
zlgxt=锣鼓喧天
zngsw=能歌善舞
zrghf=容光焕发
zngss=牛鬼蛇神
zlgxs=论功行赏
zngds=年高德劭
zlgmx=镂骨铭心
zajah=挨家挨户
zajsr=暗箭伤人
zejcb=恩将仇报
zljfg=廉洁奉公
zljbx=屡见不鲜
zljtz=励精图治
zrjsk=如饥似渴
zrjyl=日积月累
zljfl=老骥伏枥
zrjbj=忍俊不禁
zljpd=离经叛道
zljsb=乐极生悲
zljxs=落井下石
zrjsq=如胶似漆
zljjh=老奸巨猾
znjgc=鸟尽弓藏
zlkgg=劳苦功高
znkrx=囊空如洗
znkym=南柯一梦
zlkjj=临渴掘井
zamnz=爱莫能助
zamgs=安民告示
zemyx=耳目一新
zamtf=阿弥陀佛
zrmzj=燃眉之急
zlmsc=劳民伤财
znmzc=浓墨重彩
zrmcx=如梦初醒
zrmyx=茹毛饮血
zlmdk=罗曼蒂克
zlmss=老谋深算
zrmtq=日暮途穷
zlmst=老马识途
znmcf=脑满肠肥
znmes=怒目而视
zrmsx=人面兽心
zapld=安贫乐道
zlpqj=另辟蹊径
zlpld=连篇累牍
zlpzy=力排众议
zlphj=龙蟠虎踞
zlqlz=另起炉灶
zrqts=忍气吞声
zlqbz=乱七八糟
znqbd=南腔北调
znqhp=鸟枪换炮
znqlz=年轻力壮
zlqsd=零敲碎打
znqcz=弄巧成拙
zlqsj=离群索居
zlqhq=老气横秋
znqns=能屈能伸
znqwl=宁缺毋滥
znqpz=拈轻怕重
zlqcq=理屈词穷
zaskb=昂首阔步
zastq=唉声叹气
zastx=昂首挺胸
zasqb=暗送秋波
zesnx=耳熟能详
zlsyy=良师益友
znsxz=逆水行舟
zrsdf=人声鼎沸
znsjx=泥沙俱下
zrszf=如释重负
zlshs=乐善好施
zlswl=礼尚往来
znsbq=宁死不屈
zlsmf=牢骚满腹
zlsss=鹿死谁手
zlsyc=略胜一筹
znsnj=蹑手蹑脚
zlsbs=屡试不爽
zlsjz=梁上君子
zrsnf=人寿年丰
znsmd=泥塑木雕
zlsdz=劳师动众
zrssg=日上三竿
zrskb=如丧考妣
zlshz=龙蛇混杂
zatbp=凹凸不平
zatzq=安土重迁
zetmm=耳提面命
zetzz=恩同再造
zrtga=忍痛割爱
zltcy=量体裁衣
zlthy=狼吞虎咽
zltlz=老态龙钟
zltwj=雷霆万钧
zltln=愣头愣脑
zlthx=龙潭虎穴
zltbj=落拓不羁
zawjw=爱屋及乌
zlwbj=临危不惧
zlwkl=力挽狂澜
zlwzy=漏网之鱼
zexxh=恶性循环
zrxyy=日新月异
znxzj=弄虚作假
zlxqf=两袖清风
zlxjy=厉行节约
znxcn=恼羞成怒
zlxbj=离乡背井
zrxss=入乡随俗
zlxgs=例行公事
znxnd=难兄难弟
zlxwc=两小无猜
zrcwg=乳臭未干
znxys=怒形于色
zlxgf=狼心狗肺
zrxxb=人心向背
zlxpm=溜须拍马
zlxry=履险如夷
zlxgy=流星赶月
zlxcn=老羞成怒
zoxlx=呕心沥血
zayzz=安营扎寨
zayxz=安于现状
zeywz=尔虞我诈
zayfc=阿谀奉承
zeyzs=恶语中伤
zayfy=阿谀逢迎
zlybj=络绎不绝
znyzx=难以置信
znygx=年逾古稀
zlyxx=利欲熏心
znyhx=鸟语花香
zlybq=良莠不齐
zlycs=滥竽充数
zryjs=软硬兼施
znywh=内忧外患
zlyfy=流言蜚语
zrysx=如影随形
znybz=南辕北辙
zlypg=冷眼旁观
zryrs=日月如梭
zlyxy=临渊羡鱼
zlyzw=聊以自慰
zlysq=狼烟四起
zlylc=伶牙俐齿
zlyff=劳燕分飞
zryfq=饶有风趣
zrykw=人言可畏
zrycm=人烟稠密
zlyhx=龙吟虎啸
zrymf=人仰马翻
zlysg=老于世故
zryhl=人欲横流
zryzc=如蝇逐臭
zryft=肉眼凡胎
zlykk=良药苦口
znymg=奴颜媚骨
zoywz=偶一为之
zazfm=爱憎分明
zazrs=安之若素
zazms=暗中摸索
zezrs=恩重如山
zlzqz=理直气壮
zrzzz=如坐针毡
zlzbj=来者不拒
znzym=浓妆艳抹
zlzht=浪子回头
zlzdj=溜之大吉
zrzyj=仁至义尽
zlztt=临阵脱逃
zrzkj=孺子可教
znzdl=能者多劳
zlzyx=狼子野心
zlzmq=临阵磨枪
zrzyz=荣宗耀祖
znzqz=蹑足潜踪
zbebj=博而不精
zblwj=步履维艰
zblfz=拨乱反正
zblbl=不伦不类
zbnzb=不能自拔
zbleh=不劳而获
zblwy=暴露无遗
zblqs=博览群书
zblty=百里挑一
zbrdn=勃然大怒
zblst=不落俗套
zbrxj=兵戎相见
zblwc=逼良为娼
zbrgh=病入膏肓
zblsy=壁垒森严
zbrhc=步人后尘
zbnxf=笨鸟先飞
zblcg=百炼成钢
zbnsf=搬弄是非
zblkj=不落窠臼
zbnje=不念旧恶
zblhj=兵连祸结
zbrbc=悖入悖出
zblwy=别来无恙
zbres=并日而食
zblzs=暴戾恣睢
zbrfs=髀肉复生
zbbsj=勃勃生机
zbbjs=比比皆是
zbbjs=半壁江山
zbbyl=彬彬有礼
zbbjl=变本加厉
zbbbk=不卑不亢
zbbzy=不白之冤
zbbll=斑驳陆离
zbbwx=白璧无瑕
zbbyz=兵不厌诈
zbbxr=兵不血刃
zbbss=布帛菽粟
zbbzj=八拜之交
zbbql=跛鳖千里
zbcxc=别出心裁
zbczc=博采众长
zbceb=不辞而别
zbcmj=鞭长莫及
zbcsq=抱残守缺
zbcxh=报仇雪恨
zbcmm=不揣冒昧
zbchx=包藏祸心
zbdjs=博大精深
zbdec=背道而驰
zbdbl=宝刀不老
zbdxz=拔刀相助
zbhqf=百花齐放
zbhzn=不惑之年
zbhsy=不合时宜
zbhmc=变幻莫测
zbfqr=不乏其人
zbhlh=悲欢离合
zbhes=不欢而散
zbhel=不寒而栗
zbfzy=暴风骤雨
zbhdd=变化多端
zbfzy=捕风捉影
zbhml=兵荒马乱
zbhzt=抱恨终天
zbgsr=不甘示弱
zbgjm=不甘寂寞
zbgsg=闭关锁国
zbgbj=毕恭毕敬
zbgtj=博古通今
zbgss=兵贵神速
zbgqx=卑躬屈膝
zbgys=稗官野史
zbgsy=杯弓蛇影
zbgqj=卑躬屈节
zbjyg=不拘一格
zbjzy=不解之缘
zbjyg=别具一格
zbjez=不胫而走
zbjqq=并驾齐驱
zbjss=不假思索
zbjlx=背井离乡
zbjfs=饱经风霜
zbjbz=不骄不躁
zbjxj=不拘小节
zbjyg=波谲云诡
zbjgx=白驹过隙
zbjbl=半斤八两
zbjzj=败军之将
zbjjw=不咎既往
zbjxl=补苴罅漏
zbksy=不可思议
zbksx=不堪设想
zbkyy=不可逾越
zbkhs=不堪回首
zbkrm=不堪入目
zbkgr=不可告人
zbkyj=不堪一击
zbkqc=百孔千疮
zbkqj=不可企及
zbkmz=不可名状
zbkbb=不亢不卑
zbkyz=不可言状
zbkly=不可理喻
zbkmb=百口莫辩
zbkzj=不堪造就
zbmeh=不谋而合
zbmzd=不毛之地
zbmdz=本末倒置
zbmzz=拔苗助长
zbmwf=八面威风
zbmll=八面玲珑
zbmnf=班门弄斧
zbmst=闭目塞听
zbpby=不偏不倚
zbplj=杯盘狼藉
zbpzm=不平则鸣
zbqbn=不屈不挠
zbqmz=兵强马壮
zbqyj=冰清玉洁
zbqas=不欺暗室
zbscx=杯水车薪
zbsyz=背水一战
zbsss=跋山涉水
zbszk=不速之客
zbsls=逼上梁山
zbsbs=半身不遂
zbswm=榜上无名
zbssw=不识时务
zbsjx=避实就虚
zbszr=饱食终日
zbstj=不识抬举
zbsyz=别树一帜
zbsdd=板上钉钉
zbsjz=博施济众
zbsbl=不衫不履
zbskh=宝山空回
zbtef=半途而废
zbtls=遍体鳞伤
zbtmr=悲天悯人
zbtrl=暴跳如雷
zbtbj=半推半就
zbtsc=抱头鼠窜
zbttw=暴殄天物
zbwll=百无聊赖
zbwqj=博闻强记
zbxyg=不屑一顾
zbxly=标新立异
zbxsq=不徇私情
zbxby=半信半疑
zbxbb=并行不悖
zbxqy=背信弃义
zbxdc=博学多才
zbxdh=彪形大汉
zbxjj=悲喜交集
zbxny=本性难移
zbxjh=抱薪救火
zbyey=不言而喻
zbyyl=不遗余力
zbyqf=不厌其烦
zbyef=不翼而飞
zbyqf=比翼齐飞
zbybr=不依不饶
zbyxh=闭月羞花
zbzsd=不择手段
zbzsc=不知所措
zbsbn=百折不挠
zbzxg=奔走相告
zbzzz=不治之症
zbzhz=白纸黑字
zbzbd=百战不殆
zbzkf=不置可否
zbzgc=不足挂齿
zbzzz=敝帚自珍
zbzhd=不知好歹
zcebw=充耳不闻
zcewj=除恶务尽
zceqs=惩恶劝善
zclbx=川流不息
zclbc=出类拔萃
zclpt=成龙配套
zcnhk=春暖花开
zcrbp=从容不迫
zclwh=藏龙卧虎
zcrdt=趁热打铁
zclfm=初露锋芒
zcldz=层峦叠嶂
zcrsm=痴人说梦
zclpt=触类旁通
zcrbj=宠辱不惊
zcrzw=乘人之危
zcltz=垂帘听政
zclqj=春兰秋菊
zcbrd=惨不忍睹
zcbnx=寸步难行
zcbjf=猝不及防
zcbbx=常备不懈
zcbsz=赤膊上阵
zcbbl=寸步不离
zcbal=除暴安良
zcbkw=臭不可闻
zcblz=残杯冷炙
zcbbj=残兵败将
zccbq=层出不穷
zccbq=参差不齐
zccmz=踌躇满志
zccml=初出茅庐
zccbs=寸草不生
zccdf=粗茶淡饭
zccjy=从长计议
zccxy=唇齿相依
zccyy=绰绰有余
zccbq=踌躇不前
zccyd=苍翠欲滴
zccld=陈词滥调
zccbl=寸草不留
zccch=寸草春晖
zzdfz=重蹈覆辙
zcdzx=赤胆忠心
zcfpl=乘风破浪
zcfxz=冲锋陷阵
zchst=沧海桑田
zchhy=才华横溢
zchhl=沧海横流
zcfbq=此伏彼起
zchys=沧海一粟
zchtn=冲昏头脑
zchdj=趁火打劫
zcfsl=餐风宿露
zchbl=残花败柳
zcfnm=肠肥脑满
zcfyj=蹿房越脊
zchjx=厝火积薪
zcglx=陈规陋习
zcgsg=蟾宫折桂
zcgbd=才高八斗
zcglc=出乖露丑
zcgdg=称孤道寡
zcjsq=触景生情
zcjyx=辞旧迎新
zcjrh=惨绝人寰
zcjrm=草菅人命
zcjbx=除旧布新
zcjdc=层见叠出
zcjts=创巨痛深
zckcz=出口成章
zcklx=摧枯拉朽
zckjm=吹糠见米
zcmjx=触目惊心
zcmzw=驰名中外
zcmjs=瞠目结舌
zcmjj=窗明几净
zcmkl=愁眉苦脸
zcmgy=沉默寡言
zcmll=聪明伶俐
zcmbz=愁眉不展
zcmsm=慈眉善目
zcmqc=吹毛求疵
zcmjs=触目皆是
zcmyy=臭名远扬
zcmzz=臭名昭著
zcmes=侧目而视
zcmjb=草木皆兵
zcmsq=才貌双全
zcmsy=愁眉锁眼
zcmys=聪明一世
zcqbf=此起彼伏
zcqqh=承前启后
zcqzr=长驱直入
zcqbl=此起彼落
zcqbh=惩前毖后
zcqfr=锄强扶弱
zcsyy=畅所欲言
zcsjl=崇山峻岭
zcsbj=措手不及
zcsqx=承上启下
zcsrl=从善如流
zcsfr=出水芙蓉
zcszz=垂死挣扎
zcsxq=才疏学浅
zcsed=垂手而得
zcsjt=蚕食鲸吞
zcszd=初生之犊
zcsmy=春树暮云
zctwz=畅通无阻
zctsq=垂头丧气
zctcw=彻头彻尾
zctyq=串通一气
zctlm=出头露面
zctsy=蹉跎岁月
zctbc=丑态百出
zctlw=藏头露尾
zcwrd=惨无人道
zcwcb=称王称霸
zcwch=唇亡齿寒
zzwjm=重温旧梦
zcwxt=臭味相投
zcxer=乘虚而入
zcxsc=垂涎三尺
zcxyd=垂涎欲滴
zcxdz=捶胸顿足
zcxdt=长吁短叹
zcxjl=处心积虑
zcxqh=承先启后
zcxdd=称兄道弟
zcxsw=长袖善舞
zcxwx=痴心妄想
zcxyd=馋涎欲滴
zcxzy=采薪之忧
zcyar=春意盎然
zcyfh=茶余饭后
zcymw=崇洋媚外
zcydb=残垣断壁
zcybx=出言不逊
zcyzx=恻隐之心
zcygs=察言观色
zcymm=疮痍满目
zcyjb=惩一儆百
zcyly=沉鱼落雁
zcymb=沉冤莫白
zcyzy=池鱼之殃
zczfz=错综复杂
zczyh=持之以恒
zczlz=粗制滥造
zczfy=叱咤风云
zczyh=姹紫嫣红
zczgj=操之过急
zzzqg=重整旗鼓
zczjd=传宗接代
zczyb=嗤之以鼻
zczjr=才子佳人
zczdy=粗枝大叶
zcztr=处之泰然
zczyn=残渣余孽
zczmg=晨钟暮鼓
zczfh=穿凿附会
zdrwc=荡然无存
zdrbr=当仁不让
zdrnm=多如牛毛
zdlmb=顶礼膜拜
zdrxx=动人心弦
zdlhd=雕梁画栋
zdlqg=等量齐观
zdnbd=大逆不道
zdlxc=东拉西扯
zdrmj=呆若木鸡
zdnlt=大难临头
zdlth=地老天荒
zdlws=得陇望蜀
zdndq=对牛弹琴
zdnxb=多难兴邦
zdbqj=调兵遣将
zdbxj=短兵相接
zdbcy=断壁残垣
zdcjb=德才兼备
zdcdy=多才多艺
zdcsf=东窗事发
zdcxc=独出心裁
zdcjc=得寸进尺
zdcxj=雕虫小技
zdcsg=多愁善感
zdcdb=大慈大悲
zdcxy=大材小用
zdcjs=打草惊蛇
zdcdl=大吹大擂
zdcxg=蹈常袭故
zddbr=咄咄逼人
zddwb=地大物博
zddww=胆大妄为
zddbx=喋喋不休
zddys=多多益善
zddhb=颠倒黑白
zddsy=地动山摇
zddgs=咄咄怪事
zdddm=鼎鼎大名
zddyp=倒打一耙
zdhbj=大惑不解
zdfzj=登峰造极
zdfdl=大风大浪
zdflt=大发雷霆
zdfbb=大腹便便
zdhfj=倒海翻江
zdggc=大功告成
zdgrx=地广人稀
zdgws=大公无私
zdghz=刀耕火种
zdggr=达官贵人
zdhgf=单鹄寡凫
zdjxx=大街小巷
zdjjl=殚精竭虑
zdjrs=堆积如山
zdjsp=担惊受怕
zdjeg=待价而沽
zdjff=大家风范
zdjgx=大家闺秀
zdjlj=弹尽粮绝
zdjyx=荡检逾闲
zdjzg=斗鸡走狗
zdknh=豆蔻年华
zdkms=顿开茅塞
zdmdd=大名鼎鼎
zdmcx=大梦初醒
zdmsd=多谋善断
zdmar=道貌岸然
zdmfz=吊民伐罪
zdpqj=独辟蹊径
zdpxd=东跑西颠
zdqsj=大千世界
zdqpm=单枪匹马
zdqhc=荡气回肠
zdqdl=大权独揽
zdqmq=打情骂俏
zdsyz=独树一帜
zdssq=大势所趋
zdsbl=滴水不漏
zdscb=滴水成冰
zdsxp=东施效颦
zdsqs=独善其身
zdsfj=大煞风景
zdsds=颠三倒四
zdspy=箪食瓢饮
zdtdh=得天独厚
zdttg=打退堂鼓
zdtts=道听途说
zdtgz=大庭广众
zdtyb=当头一棒
zdtbh=当头棒喝
zdthy=点头哈腰
zdtfy=党同伐异
zdtdn=呆头呆脑
zdwzd=弹丸之地
zdwsr=睹物思人
zdxjt=大相径庭
zdxsz=等闲视之
zdxns=倒行逆施
zdxgw=大喜过望
zdxjh=短小精悍
zdxdh=涤瑕荡秽
zdydb=大摇大摆
zdylr=大义凛然
zdywx=得意忘形
zdypx=戴月披星
zdzqg=大张旗鼓
zdzwk=当之无愧
zdzxy=对症下药
zdzat=独占鳌头
zdzay=斗志昂扬
zdzqy=断章取义
zdzzs=鼎足之势
zdzry=大智若愚
zdzlg=戴罪立功
zdzbc=丢卒保车
zdztf=大张挞伐
zdzdj=动辄得咎
zhebf=惠而不费
zhebq=怙恶不悛
zhryx=焕然一新
zflcz=泛滥成灾
zhrkl=豁然开朗
zhryt=浑然一体
zhljb=汗流浃背
zhrdw=恍然大悟
zfrjz=妇孺皆知
zflxy=扶老携幼
zhryh=浩如烟海
zhrtw=骇人听闻
zhnyg=患难与共
zhljq=鹤立鸡群
zflht=返老还童
zhlsw=寒来暑往
zhrbj=诲人不倦
zflfq=翻来覆去
zhncd=汗牛充栋
zhnzj=患难之交
zhltz=囫囵吞枣
zfltt=风流倜傥
zflfm=非驴非马
zhlhs=花里胡哨
zhrym=花容月貌
zhrgs=恍如隔世
zfrsm=奉若神明
zfrdh=福如东海
zflys=风流云散
zflzk=发聋振聩
zflxh=放浪形骸
zfbgs=奋不顾身
zhbxs=红白喜事
zhbdx=祸不单行
zfbws=反败为胜
zfbsd=腹背受敌
zfblx=分崩离析
zhbxy=虎背熊腰
zhbcj=画饼充饥
zhbyf=含苞欲放
zhblt=欢蹦乱跳
zhbft=魂不附体
zhbss=魂不守舍
zhbzj=缓兵之计
zhblq=黑不溜秋
zfbdz=罚不当罪
zfcpp=风尘仆仆
zfcls=风餐露宿
zfcdc=风驰电掣
zfccd=风吹草动
zfcyd=风吹雨打
zhczz=横冲直撞
zhcbb=厚此薄彼
zhctj=祸从天降
zhcdq=回肠荡气
zfcxj=反唇相讥
zfcjb=非此即彼
zhcll=酣畅淋漓
zhckc=祸从口出
zfczx=逢场作戏
zhczx=回嗔作喜
zfdcx=釜底抽薪
zfdpp=风度翩翩
zfdyb=分道扬镳
zhdxg=好大喜功
zhdhs=患得患失
zhdwl=画地为牢
zhdbj=荒诞不经
zhddd=豁达大度
zfdbj=放荡不羁
zhdxb=邯郸学步
zfdsj=风刀霜剑
zhdly=海底捞月
zhdwj=荒诞无稽
zhddl=画栋雕梁
zfdyy=釜底游鱼
zhhll=轰轰烈烈
zffyy=沸沸扬扬
zhhdd=浩浩荡荡
zfftq=奋发图强
zhhym=赫赫有名
zffzy=肺腑之言
zfhzm=风华正茂
zfhrl=风和日丽
zhhqy=欢呼雀跃
zffyy=纷纷扬扬
zhhry=挥汗如雨
zfhsj=繁花似锦
zhfhy=呼风唤雨
zfhsl=发号施令
zfftq=发愤图强
zhhwq=后患无穷
zffyw=奋发有为
zhhyy=花好月圆
zhfym=灰飞烟灭
zhfty=鹤发童颜
zfhwr=防患未然
zffsz=凡夫俗子
zfhtd=飞黄腾达
zhhqc=含糊其辞
zhhys=昏昏欲睡
zhhee=浑浑噩噩
zhhll=花红柳绿
zffdd=疯疯癫癫
zhfps=魂飞魄散
zffet=泛泛而谈
zhgzy=后顾之忧
zfgwj=丰功伟绩
zhgss=湖光山色
zfgqb=富国强兵
zfgly=浮光掠影
zfgsf=奉公守法
zhgym=祸国殃民
zhgzx=悔过自新
zfgzs=反躬自省
zhgwy=好高骛远
zfgxy=封官许愿
zhgfz=回光返照
zhgld=黑咕隆咚
zhgrr=含垢忍辱
zhgtc=和光同尘
zhgbj=厚古薄今
zhjyt=欢聚一堂
zfjzx=抚今追昔
zhjrt=挥金如土
zfjdh=翻江倒海
zfjcy=风卷残云
zhjjy=讳疾忌医
zfjqz=负荆请罪
zhjhw=狐假虎威
zhjmc=胡搅蛮缠
zhjty=海角天涯
zhjbg=厚今薄古
zhjlx=花街柳巷
zhktk=海阔天空
zfklj=风口浪尖
zhkby=虎口拔牙
zhkba=惶恐不安
zhksl=海枯石烂
zhmgl=汗马功劳
zfmlj=凤毛麟角
zfmdc=粉墨登场
zhmrs=讳莫如深
zhmsz=火冒三丈
zfmbl=锋芒毕露
zhmjl=荒谬绝伦
zhmsy=横眉竖眼
zfmsx=锋芒所向
zhmnm=横眉怒目
zfplj=风平浪静
zhptc=和盘托出
zhpjz=鸿篇巨制
zhpgy=狐朋狗友
zfqyy=风起云涌
zfqzz=奋起直追
zfqws=废寝忘食
zhqsd=荷枪实弹
zhqzz=豪情壮志
zhqsb=横七竖八
zhqmy=魂牵梦萦
zfqzs=飞禽走兽
zhqcc=浩气长存
zhqmm=含情脉脉
zhqxq=祸起萧墙
zfqyz=封妻荫子
zhqgd=狐群狗党
zfsyl=翻山越岭
zhsjq=婚丧嫁娶
zhssl=海市蜃楼
zhshs=绘声绘色
zhsdm=好事多磨
zhsdd=虎视眈眈
zfssg=粉身碎骨
zhsds=好说歹说
zhsjy=火上浇油
zhszr=挥洒自如
zhsmy=混水摸鱼
zhskw=后生可畏
zfsjs=俯拾即是
zhsld=欢声雷动
zhshl=火烧火燎
zhsbd=胡说八道
zhsqj=横扫千军
zhsmy=浑水摸鱼
zfsjs=愤世嫉俗
zhstz=画蛇添足
zhsmm=火烧眉毛
zfstp=粉饰太平
zhssm=海誓山盟
zhszj=横生枝节
zfste=俯首帖耳
zhshj=慌手慌脚
zfsns=覆水难收
zhszt=好事之徒
zhsby=荒时暴月
zftfd=翻天覆地
zhtjc=花团锦簇
zhtxd=欢天喜地
zftkl=分庭抗礼
zhtsw=虎头蛇尾
zftdh=赴汤蹈火
zhthd=昏天黑地
zhtdx=哄堂大笑
zhtqd=呼天抢地
zhtfs=回天乏术
zhthn=虎头虎脑
zhthn=昏头昏脑
zhwyt=混为一谈
zhwwq=回味无穷
zhwwy=化为乌有
zfwdj=防微杜渐
zhwry=荒无人烟
zhwyy=毫无疑义
zfwjk=扶危济困
zhwez=毫无二致
zfwrj=繁文缛节
zfxwa=方兴未艾
zhxgw=欢欣鼓舞
zhxrk=含辛茹苦
zhxwy=化险为夷
zfxlp=浮想联翩
zfxeq=拂袖而去
zfxdg=翻箱倒柜
zhxyq=沆瀣一气
zhxbd=横行霸道
zhxst=混淆视听
zhxsq=灰心丧气
zhxsf=混淆是非
zfxhj=逢凶化吉
zhxhb=混淆黑白
zfyzs=扶摇直上
zfytz=风雨同舟
zhyyd=毁于一旦
zhyzy=豪言壮语
zfywz=风雨无阻
zfyzs=丰衣足食
zfypy=风雨飘摇
zfyel=蜂拥而来
zhyqy=花言巧语
zfyfy=附庸风雅
zhyel=好逸恶劳
zfysz=敷衍塞责
zfyls=敷衍了事
zfyss=匪夷所思
zfywk=负隅顽抗
zhyys=和颜悦色
zhywc=厚颜无耻
zfybh=飞扬跋扈
zhycb=毁誉参半
zfyrh=风雨如晦
zfydx=奋勇当先
zhyns=含饴弄孙
zhyty=烘云托月
zfyyr=俯仰由人
zhybj=狐疑不决
zfztl=纷至沓来
zhzjs=货真价实
zhzwl=化整为零
zfzdl=付之东流
zhzqc=哗众取宠
zfzdl=付诸东流
zfzyj=付之一炬
zhzzz=花枝招展
zfzcn=风烛残年
zfzyx=付之一笑
zhzbl=横征暴敛
zfzxl=福至心灵
zhzql=火中取栗
zfzzl=发指眦裂
zhzyx=好整以暇
zhzzf=涸辙之鲋
zgagh=隔岸观火
zgedd=感恩戴德
zgetb=感恩图报
zgrff=感人肺腑
zgrxj=刚柔相济
zgnxx=故弄玄虚
zglzz=顾虑重重
zglgw=孤陋寡闻
zgrjt=固若金汤
zglwy=孤立无援
zglxc=寡廉鲜耻
zgntd=肝脑涂地
zgbzf=固步自封
zgbkp=高不可攀
zgbdz=寡不敌众
zgbcc=功败垂成
zgbzf=故步自封
zgbxf=甘拜下风
zgbzy=刚愎自用
zgbsc=公报私仇
zgcdm=光彩夺目
zgcsb=顾此失彼
zgcjj=各持己见
zgcjc=觥筹交错
zgccd=肝肠寸断
zgcnz=孤臣孽子
zgcms=功成名遂
zgdxz=肝胆相照
zgdrc=古道热肠
zgdym=功德圆满
zgdjs=绠短汲深
zgflj=高风亮节
zgfsg=鬼斧神工
zgfzs=孤芳自赏
zghrx=蛊惑人心
zghcq=过河拆桥
zgfjy=光风霁月
zghsp=勾魂摄魄
zghyg=孤魂野鬼
zggbr=格格不入
zggll=光怪陆离
zggyh=耿耿于怀
zgggd=鳏寡孤独
zggwy=亘古未有
zggdx=革故鼎新
zggxh=官官相护
zggsd=歌功颂德
zgghl=高官厚禄
zggls=滚瓜烂熟
zggss=鬼鬼祟祟
zggzh=骨鲠在喉
zgjll=干净利落
zgjfz=孤军奋战
zgjls=过街老鼠
zgjtq=狗急跳墙
zgjzy=故伎重演
zgjtl=感激涕零
zgjgr=孤家寡人
zgjdd=诡计多端
zgjsj=赶尽杀绝
zgkwq=感慨万千
zgkyk=功亏一篑
zgkld=孤苦伶仃
zgklh=鬼哭狼嚎
zgklc=管窥蠡测
zgmxk=刮目相看
zgmll=光明磊落
zgmth=冠冕堂皇
zgmnw=概莫能外
zgmdy=沽名钓誉
zgmxq=鬼迷心窍
zgmgy=怪模怪样
zgmcs=过目成诵
zgmsh=槁木死灰
zgqye=隔墙有耳
zgqts=苟且偷生
zgqta=苟且偷安
zgqbb=攻其不备
zgsdg=根深蒂固
zgsjj=各抒己见
zgsym=根深叶茂
zgsrc=骨瘦如柴
zgsdl=瓜熟蒂落
zgsmc=高深莫测
zgsyz=高山仰止
zgskb=高视阔步
zgswl=格杀勿论
zgsws=盖世无双
zgtma=国泰民安
zgtkl=高谈阔论
zgtgs=高抬贵手
zgtfm=故态复萌
zgtgn=鬼头鬼脑
zgtwx=歌台舞榭
zgtlx=瓜田李下
zgwjl=高屋建瓴
zgwsp=歌舞升平
zgwmj=拐弯抹角
zgwxd=狗尾续貂
zgwtz=姑妄听之
zgwyz=姑妄言之
zgxyz=改弦易辙
zgxgz=改弦更张
zgxsj=归心似箭
zgxyj=姑息养奸
zgxdj=勾心斗角
zgxsy=隔靴搔痒
zgxpt=狗血喷头
zgxjj=孤行己见
zgysj=光阴似箭
zgycc=苟延残喘
zgylw=挂一漏万
zgybj=过犹不及
zgyht=官运亨通
zgyzl=顾影自怜
zgywz=官样文章
zgybr=干云蔽日
zgzyz=高瞻远瞩
zgzyz=公之于众
zgzwy=高枕无忧
zgzbq=裹足不前
zgzyc=各执一词
zgzyz=孤注一掷
zgzyz=光宗耀祖
zgznm=孤掌难鸣
zgzjj=固执己见
zgzkb=管中窥豹
zgzgs=故作高深
zgzry=甘之如饴
zjasw=居安思危
zjasb=节哀顺变
zjeyz=敬而远之
zjerc=疾恶如仇
zjrbt=截然不同
zjlwm=价廉物美
zjnxz=艰难险阻
zjlcj=积劳成疾
zjrjz=尽人皆知
zjrbt=迥然不同
zjrjz=见仁见智
zjnxz=解囊相助
zjrlx=寄人篱下
zjrps=坚如磐石
zjnmj=锦囊妙计
zjlyt=急流勇退
zjrbb=坚忍不拔
zjrzz=矫揉造作
zjrbb=兼容并包
zjlzs=嗟来之食
zjlcj=江郎才尽
zjrhc=噤若寒蝉
zjrjy=假仁假义
zjbhh=金碧辉煌
zjbjz=精兵简政
zjbzs=饥不择食
zjbnz=剑拔弩张
zjbkc=坚不可摧
zjbtm=金榜题名
zjbrf=健步如飞
zjbqy=坚壁清野
zjbrf=间不容发
zjbbb=骄兵必败
zjcbf=家常便饭
zjctk=金蝉脱壳
zjcll=饥肠辘辘
zjcba=局促不安
zjcbd=截长补短
zjctc=进寸退尺
zjctc=金城汤池
zjdby=坚定不移
zjdxs=精打细算
zjdhx=皆大欢喜
zjdxk=精雕细刻
zjdqc=就地取材
zjdsg=见多识广
zjdzy=旧地重游
zjdys=结党营私
zjdzw=井底之蛙
zjdzd=旧调重弹
zjfxb=今非昔比
zjfcz=见缝插针
zjhsc=惊慌失措
zjhjp=饥寒交迫
zjfby=急风暴雨
zjhwd=惊魂未定
zjfdd=鸡飞蛋打
zjhyr=嫁祸于人
zjher=酒酣耳热
zjfjp=劫富济贫
zjfsd=见风使舵
zjhxf=借花献佛
zjhsy=镜花水月
zjhyf=救火扬沸
zjgjc=鞠躬尽瘁
zjgxz=精耕细作
zjglx=居高临下
zjgtm=金戈铁马
zjgza=居功自傲
zjgjs=假公济私
zjgzn=惊弓之鸟
zjgbg=将功补过
zjgfj=借古讽今
zjgsz=将功赎罪
zjgjj=加官进爵
zjjyy=兢兢业业
zjjql=竭尽全力
zjjld=津津乐道
zjjnz=绞尽脑汁
zjjhs=聚精会神
zjjyt=井井有条
zjjyw=津津有味
zjjkw=岌岌可危
zjjjz=戒骄戒躁
zjjjj=斤斤计较
zjjyt=济济一堂
zjjlb=坚甲利兵
zjjsf=拒谏饰非
zjkzj=艰苦卓绝
zjkbd=叫苦不迭
zjklt=叫苦连天
zjkyl=金科玉律
zjkwz=惊恐万状
zjkcy=交口称誉
zjmqg=精明强干
zjmsp=鸡毛蒜皮
zjmny=挤眉弄眼
zjmgd=鸡鸣狗盗
zjplj=精疲力尽
zjprw=家破人亡
zjplj=精疲力竭
zjplj=筋疲力尽
zjphf=鸡皮鹤发
zjqjs=驾轻就熟
zjqqx=捐弃前嫌
zjqbn=鸡犬不宁
zjqbq=坚强不屈
zjqst=鸡犬升天
zjqay=佶屈聱牙
zjqjb=夹七夹八
zjqbl=鸡犬不留
zjsgy=集思广益
zjsth=锦上添花
zjsfs=救死扶伤
zjsjm=尽善尽美
zjsds=精神抖擞
zjsbx=兼收并蓄
zjshf=精神焕发
zjszh=洁身自好
zjsgy=娇生惯养
zjscd=积少成多
zjshs=惊世骇俗
zjszd=监守自盗
zjshh=借尸还魂
zjsyy=骄奢淫逸
zjskb=尖酸刻薄
zjsrc=惊蛇入草
zjslq=结驷连骑
zjtsd=脚踏实地
zjtxw=街头巷尾
zjthl=惊涛骇浪
zjtfh=借题发挥
zjtle=焦头烂额
zjtje=交头接耳
zjtwd=经天纬地
zjwjy=据为己有
zjwsz=节外生枝
zjwth=精卫填海
zjwfm=泾渭分明
zjwtc=救亡图存
zjwgz=矫枉过正
zjwbj=既往不咎
zjxdp=惊心动魄
zjxhy=交相辉映
zjxjl=尽心竭力
zjxjy=将信将疑
zjxsw=谨小慎微
zjxpc=居心叵测
zjxyw=九霄云外
zjxll=娇小玲珑
zjxbl=江心补漏
zjxjj=惊喜交集
zjxxk=锦心绣口
zjxyz=金相玉质
zjyyw=见义勇为
zjyhx=家喻户晓
zjyqj=精益求精
zjyyx=记忆犹新
zjyss=节衣缩食
zjysq=见异思迁
zjycq=集腋成裘
zjyzq=咎由自取
zjycx=决一雌雄
zjymt=金玉满堂
zjyls=疾言厉色
zjytc=加油添醋
zjycz=积羽沉舟
zjzxd=捷足先登
zjzez=接踵而至
zjzel=接踵而来
zjzzc=近在咫尺
zjznf=积重难返
zjzsz=急中生智
zjzey=竭泽而渔
zjzbq=坚贞不屈
zjzxs=箭在弦上
zjzyq=激浊扬清
zjzyy=金枝玉叶
zjzhs=尖嘴猴腮
zjzbs=尖嘴薄舌
zjzlc=积铢累寸
zkrcj=旷日持久
zkrxx=扣人心弦
zkrbd=岿然不动
zkrxh=口若悬河
zkbrh=刻不容缓
zkbky=苦不堪言
zkbcj=溃不成军
zkbyb=窥豹一斑
zkczj=可乘之机
zkcbg=开诚布公
zkcxj=开诚相见
zkdqc=夸大其词
zkdcs=苦大仇深
zkfby=狂风暴雨
zkfzr=夸父逐日
zkhdl=宽宏大量
zkgkq=可歌可泣
zkgmx=刻骨铭心
zkgzy=空谷足音
zkjfg=克己奉公
zkjgl=苦尽甘来
zkjyy=开卷有益
zkjzs=苛捐杂税
zkjfl=克己复礼
zkket=侃侃而谈
zkkjn=慷慨解囊
zkkpx=苦口婆心
zkkww=坑坑洼洼
zkkcc=慷慨陈词
zkkpp=磕磕碰碰
zkkbb=磕磕绊绊
zkkqt=夸夸其谈
zkmgp=坑蒙拐骗
zkmjb=快马加鞭
zkmfc=枯木逢春
zkmfj=口蜜腹剑
zkqkj=克勤克俭
zksmx=苦思冥想
zkszl=哭丧着脸
zkswp=口说无凭
zksyd=困兽犹斗
zktpd=开天辟地
zkwyl=孔武有力
zkxjy=苦心经营
zkxlf=空穴来风
zkxgy=苦心孤诣
zkzrk=脍炙人口
zkzmy=开宗明义
zkzdd=康庄大道
zkzlg=空中楼阁
zkzbf=口诛笔伐
zkzby=枯枝败叶
zkzqj=刻舟求剑
zmebx=秘而不宣
zmlqm=名列前茅
zmltx=忙里偷闲
zmlkd=鸣锣开道
zmllk=模棱两可
zmrzz=漠然置之
zmnzj=莫逆之交
zmrxm=盲人瞎马
zmlcz=绵里藏针
zmbtt=马不停蹄
zmbxj=目不暇接
zmbxc=名不虚传
zmbjx=漫不经心
zmbls=民不聊生
zmbgx=漠不关心
zmbky=妙不可言
zmbsd=目不识丁
zmbjl=蛮不讲理
zmbsh=妙笔生花
zmbjj=目不交睫
zmcsw=名存实亡
zmcaf=明察暗访
zmcqh=明察秋毫
zmcqs=名垂青史
zmcbw=没齿不忘
zmcqg=名垂千古
zmccz=磨杵成针
zmdzz=灭顶之灾
zmddz=酩酊大醉
zmfsw=眉飞色舞
zmhjs=面黄肌瘦
zmhec=面红耳赤
zmhgg=蒙混过关
zmfjl=满腹经纶
zmhsl=貌合神离
zmgsr=毛骨悚然
zmgcz=暮鼓晨钟
zmggs=马革裹尸
zmgqr=卖国求荣
zmgrj=目光如炬
zmgrd=目光如豆
zmjjz=摩肩接踵
zmjdc=没精打采
zmjgx=明镜高悬
zmkyx=每况愈下
zmklq=门可罗雀
zmmww=默默无闻
zmmyq=梦寐以求
zmmfd=名目繁多
zmmqm=莫名其妙
zmmjd=面面俱到
zmmcy=满目疮痍
zmmbr=麻木不仁
zmmbl=闷闷不乐
zmmxq=面面相觑
zmmdt=冒名顶替
zmmlb=秣马厉兵
zmmhq=脉脉含情
zmmzy=靡靡之音
zmmkz=面目可憎
zmmwy=默默无言
zmqhs=妙趣横生
zmqcz=摩拳擦掌
zmqaj=明枪暗箭
zmsdc=名山大川
zmsby=漫山遍野
zmscg=墨守成规
zmszj=毛遂自荐
zmsdk=茅塞顿开
zmshc=妙手回春
zmskx=冥思苦想
zmssz=马首是瞻
zmsjy=面授机宜
zmsmj=毛手毛脚
zmsqx=瞒上欺下
zmtkg=埋头苦干
zmtrs=门庭若市
zmtgh=瞒天过海
zmtzf=迷途知返
zmtdz=弥天大罪
zmtdh=弥天大谎
zmwqn=勉为其难
zmwbj=漫无边际
zmwbl=冥顽不灵
zmwtx=茫无头绪
zmycz=木已成舟
zmyft=民怨沸腾
zmzys=莫衷一是
zmzys=名噪一时
zmzgf=明知故犯
zmzgl=蒙在鼓里
zmzbs=明哲保身
zmzgw=明知故问
zmzmg=民脂民膏
zprdw=庞然大物
zprwr=旁若无人
zplff=攀龙附凤
zpnjf=排难解纷
zpbjd=迫不及待
zpbdy=迫不得已
zpbwg=平白无故
zpbyc=喷薄欲出
zpbwj=朋比为奸
zpcwl=鹏程万里
zpfcz=破釜沉舟
zpfyz=匹夫有责
zphdh=披红戴花
zpfzy=匹夫之勇
zpfhs=蚍蜉撼树
zpfcz=剖腹藏珠
zpgld=披肝沥胆
zpgwd=刨根问底
zpgzq=旁观者清
zpgnl=屁滚尿流
zpjzj=披荆斩棘
zpjzy=破镜重圆
zpjzr=披坚执锐
zfjtl=否极泰来
zpjsc=牝鸡司晨
zpkrz=皮开肉绽
zpmzd=旁门左道
zppqw=翩翩起舞
zppzx=平铺直叙
zpsml=扑朔迷离
zpsxf=萍水相逢
zpsjj=披沙拣金
zpsqw=婆娑起舞
zptgd=铺天盖地
zptgm=蓬头垢面
zptlm=抛头露面
zptgl=劈头盖脸
zptwx=破涕为笑
zptsf=披头散发
zpwwc=片瓦无存
zpxdy=披星戴月
zpxjq=平心静气
zpybm=疲于奔命
zpyhj=璞玉浑金
zpzmj=迫在眉睫
zpzyy=抛砖引玉
zpzby=旁征博引
zpzbc=破绽百出
zpzyl=铺张扬厉
zqatm=弃暗投明
zqagl=乞哀告怜
zqebs=锲而不舍
zqehg=穷而后工
zqltt=千里迢迢
zqlmm=巧立名目
zqrqf=恰如其分
zqldy=枪林弹雨
zqryt=杞人忧天
zqrxp=沁人心脾
zqlwq=其乐无穷
zqlzs=妻离子散
zqnzm=强弩之末
zqrts=欺人太甚
zqnbz=勤能补拙
zqlgw=曲里拐弯
zqljq=黔驴技穷
zqrpy=欺软怕硬
zqrzt=欺人之谈
zqngx=轻诺寡信
zqlyy=琼楼玉宇
zqnly=穷年累月
zqlys=千虑一失
zqlyd=千虑一得
zqbcs=泣不成声
zqbdw=穷兵黩武
zqcbd=取长补短
zqcql=群策群力
zqcyy=气喘吁吁
zqcjc=轻车简从
zqczj=前车之鉴
zqcgd=牵肠挂肚
zqcbk=千疮百孔
zqcbl=千锤百炼
zqcyl=青出于蓝
zqczz=浅尝辄止
zqcsl=轻车熟路
zqcqj=去粗取精
zqcdr=奇耻大辱
zqcdc=钦差大臣
zqccd=倾巢出动
zqcth=切齿痛恨
zqcxh=气冲霄汉
zqcjz=鹊巢鸠占
zqcqg=倾城倾国
zqdhc=恰到好处
zqdjt=拳打脚踢
zqdtg=巧夺天工
zqdcz=屈打成招
zqfzt=切肤之痛
zqhnx=骑虎难下
zqhkj=奇货可居
zqhhy=前呼后拥
zqhwf=秋毫无犯
zqfds=棋逢对手
zqhyt=漆黑一团
zqhzb=青红皂白
zqfky=凄风苦雨
zqgjq=前功尽弃
zqgqs=秋高气爽
zqghg=曲高和寡
zqgxd=旗鼓相当
zqgjl=清规戒律
zqgmw=轻歌曼舞
zqgch=气贯长虹
zqgxs=敲骨吸髓
zqgzc=切骨之仇
zqjdc=倾家荡产
zqjfm=全军覆没
zqjyf=千钧一发
zqjty=曲径通幽
zqjwd=轻举妄动
zqjbh=气急败坏
zqjtx=弃旧图新
zqjzh=秦晋之好
zqjyz=千金一掷
zqjmy=强奸民意
zqjrw=请君入瓮
zqjhg=前倨后恭
zqjzf=千钧重负
zqjbm=千娇百媚
zqjwl=穷极无聊
zqjyh=取精用弘
zqjyb=弃甲曳兵
zqkds=旗开得胜
zqmwj=亲密无间
zqmdx=轻描淡写
zqmby=其貌不扬
zqmzm=青梅竹马
zqmzl=犬马之劳
zqmlw=群魔乱舞
zqmly=青面獠牙
zqpyl=千篇一律
zqphj=前仆后继
zqpdy=倾盆大雨
zqqzb=求全责备
zqqhd=巧取豪夺
zqqsy=窃窃私语
zqqfh=牵强附会
zqqjz=谦谦君子
zqqww=卿卿我我
zqsbb=气势磅礴
zqsgz=全神贯注
zqswl=千丝万缕
zqses=穷山恶水
zqsxx=气势汹汹
zqsmx=欺上瞒下
zqsdm=欺世盗名
zqsrh=巧舌如簧
zqsjc=穷奢极侈
zqssq=情随事迁
zqsqq=怯声怯气
zqspe=欺善怕恶
zqtcy=求同存异
zqtwx=千头万绪
zqtsh=气吞山河
zqtml=穷途末路
zqtpl=晴天霹雳
zqtds=蜻蜓点水
zqtck=亲痛仇快
zqtqw=掐头去尾
zqtgs=清汤寡水
zqtgr=情同骨肉
zqtws=求田问舍
zqwcz=去伪存真
zqwxt=气味相投
zqwwq=其味无穷
zqxxl=齐心协力
zqxwk=千辛万苦
zqxpr=穷乡僻壤
zqxje=穷凶极恶
zqxkl=勤学苦练
zqxgz=奇形怪状
zqxgy=清心寡欲
zqymh=潜移默化
zqyzj=权宜之计
zqyjc=犬牙交错
zqyxz=气焰嚣张
zqyfs=趋炎附势
zqyxa=器宇轩昂
zqyhx=强颜欢笑
zqyfy=曲意逢迎
zqyls=巧言令色
zqznf=千载难逢
zqzks=屈指可数
zqzlj=清正廉洁
zqzls=敲诈勒索
zqzrw=趋之若鹜
zqzhj=轻重缓急
zqzth=起早贪黑
zqzwq=千真万确
zqzsb=穷则思变
zqzsh=气壮山河
zqzdb=乔装打扮
zqzyb=奇珍异宝
zqzyf=奇装异服
zqzns=罄竹难书
zqzdz=轻重倒置
zsebj=视而不见
zsebs=十恶不赦
zsebz=述而不作
zsefy=丝恩发怨
zslcz=顺理成章
zsrqj=肃然起敬
zsrqc=深入浅出
zslqj=身临其境
zsrjr=水乳交融
zsrlx=潸然泪下
zsrtw=耸人听闻
zsljx=声泪俱下
zsrpz=势如破竹
zsrlj=损人利己
zsnxn=善男信女
zsryh=杀人越货
zsrwd=视若无睹
zsnsq=熟能生巧
zsltj=沙里淘金
zsnjw=十拿九稳
zsltt=生灵涂炭
zsrww=索然无味
zslyc=生拉硬扯
zslnr=色厉内荏
zslzq=始乱终弃
zsrkc=视如寇仇
zsrrs=爽然若失
zsbxs=素不相识
zsbzl=随波逐流
zsbyt=生搬硬套
zsbkd=势不可挡
zsbyj=身不由己
zsblc=树碑立传
zsbyy=散兵游勇
zsbml=身败名裂
zsbgq=事必躬亲
zsbgf=食不果腹
zsbkc=深不可测
zsbzm=舍本逐末
zsbkn=俗不可耐
zsbmm=死不瞑目
zsbsj=手不释卷
zsbdl=山崩地裂
zsbsj=损兵折将
zscjy=省吃俭用
zscyy=神采奕奕
zscxs=似曾相识
zscrj=受宠若惊
zscaw=恃才傲物
zsczy=疏财仗义
zscqh=势成骑虎
zscrx=深藏若虚
zsdqf=适得其反
zsdqc=水到渠成
zsdzs=僧多粥少
zsdgz=失道寡助
zsdql=手到擒来
zsdwz=数典忘祖
zsdwp=硕大无朋
zsdsc=水滴石穿
zsdjk=四大皆空
zshfr=死灰复燃
zsfkx=煞费苦心
zsfwl=四分五裂
zshdd=神魂颠倒
zsfjj=删繁就简
zsfbs=伤风败俗
zshlp=失魂落魄
zsfdh=煽风点火
zshlp=丧魂落魄
zsfqh=适逢其会
zsfzd=顺风转舵
zsgqx=双管齐下
zsgml=三顾茅庐
zsgjq=时过境迁
zsgjc=硕果仅存
zsgbh=食古不化
zsggf=神工鬼斧
zsgjq=事过境迁
zsjbb=生机勃勃
zsjqy=舍近求远
zsjjr=舍己救人
zsjbm=拾金不昧
zsjys=盛极一时
zsjql=杀鸡取卵
zsjtl=丧尽天良
zsjwr=舍己为人
zsjms=神机妙算
zsjjc=深居简出
zsjzq=丧家之犬
zsjmd=绳锯木断
zsjwg=舍己为公
zsjbx=数见不鲜
zsjzp=嗜痂之癖
zsjcq=舌剑唇枪
zsjxh=杀鸡吓猴
zskjg=司空见惯
zskfr=矢口否认
zskez=适可而止
zskrp=守口如瓶
zsmbf=四面八方
zsmyd=拭目以待
zsmyl=深谋远虑
zsmcg=四面楚歌
zsmps=素昧平生
zsmcg=鼠目寸光
zsmlj=声名狼藉
zsmnz=驷马难追
zsmhs=山盟海誓
zsmec=数米而炊
zspbw=四平八稳
zspll=死皮赖脸
zsqyz=首屈一指
zsqbb=生气勃勃
zsqhy=深情厚谊
zsqsj=山穷水尽
zsqlz=身强力壮
zsqrg=丧权辱国
zsqbm=声情并茂
zsqlr=盛气凌人
zsqtt=杀气腾腾
zsqlr=恃强凌弱
zsqsz=神气十足
zsqfz=食前方丈
zsqfr=蜀犬吠日
zsshd=声势浩大
zsswc=束手无策
zsssl=深思熟虑
zsscw=生死存亡
zssxz=莘莘学子
zssbx=生生不息
zssrg=视死如归
zsssz=善始善终
zssws=舍生忘死
zssyg=生死攸关
zsslc=姗姗来迟
zssqy=顺手牵羊
zsslj=声嘶力竭
zsssj=缩手缩脚
zsstz=顺水推舟
zssjl=声色俱厉
zssjq=束手就擒
zssqy=舍生取义
zsscr=杀身成仁
zssfh=随声附和
zssyd=生杀予夺
zssdb=束手待毙
zssyc=身首异处
zssld=首鼠两端
zssqc=闪烁其辞
zssyc=稍胜一筹
zsssj=束手束脚
zsskc=搜索枯肠
zssbe=誓死不二
zssch=社鼠城狐
zstbd=四通八达
zstkl=酸甜苦辣
zstmg=顺藤摸瓜
zsttg=殊途同归
zstyl=世态炎凉
zsthb=生吞活剥
zstrx=视同儿戏
zstsn=缩头缩脑
zswql=史无前例
zsetj=深恶痛绝
zswjd=肆无忌惮
zswty=世外桃源
zswzd=手舞足蹈
zswhj=十万火急
zswct=手无寸铁
zswyl=送往迎来
zswsm=塞翁失马
zswdz=识文断字
zsxwb=瞬息万变
zsxym=赏心悦目
zsxsz=身先士卒
zsxbt=水泄不通
zsxbk=丧心病狂
zsxby=深信不疑
zsxpm=所向披靡
zsxcs=甚嚣尘上
zsxxx=上行下效
zsxtd=死心塌地
zsxzn=私心杂念
zsxym=夙兴夜寐
zsyyw=事与愿违
zsyqq=声誉鹊起
zsyjs=煞有介事
zsyjb=杀一儆百
zsybq=拾遗补阙
zsyyg=死有余辜
zszby=始终不渝
zszry=始终如一
zszdl=三足鼎立
zszyf=绳之以法
zszgg=束之高阁
zszjs=稍纵即逝
zszby=矢志不渝
zszjb=失之交臂
zszhw=山珍海味
zszyz=始作俑者
zszwc=手足无措
zszdt=守株待兔
zszzq=寿终正寝
zszsj=速战速决
zszbj=十之八九
zszpz=耍嘴皮子
zszdy=深宅大院
zszly=水中捞月
ztehz=堂而皇之
zdezx=铤而走险
ztexj=同恶相济
ztrql=突如其来
ztlzl=天伦之乐
ztrzb=天壤之别
ztlhz=偷梁换柱
ztnsh=天女散花
ztlhw=同流合污
ztrcz=泰然处之
ztnds=拖泥带水
ztrzr=泰然自若
ztlwg=徒劳无功
ztnqw=探囊取物
ztnry=天怒人怨
ztldz=探骊得珠
ztlxc=跳梁小丑
ztbzl=推波助澜
ztbcr=投笔从戎
ztbss=退避三舍
ztbwj=土崩瓦解
ztbyk=铁板一块
ztbxl=同病相怜
ztblj=挑拨离间
ztbtq=铁壁铜墙
ztbzc=恬不知耻
ztbdc=螳臂当车
ztbdl=投鞭断流
ztccx=推陈出新
ztcdk=同仇敌忾
ztcym=同床异梦
ztcxj=推诚相见
ztcys=太仓一粟
ztdwy=贪得无厌
ztdcq=天道酬勤
ztfmj=突飞猛进
zthry=谈何容易
ztfyt=天方夜谭
ztfzg=天府之国
zthyx=昙花一现
ztfdf=天翻地覆
zthdd=天寒地冻
zthlz=天花乱坠
zthda=天昏地暗
ztfjs=挑肥拣瘦
zthbz=蜕化变质
zthls=土豪劣绅
zthgd=醍醐灌顶
zthyg=铁画银钩
zthdl=天荒地老
ztgjl=偷工减料
ztggk=同甘共苦
ztgwl=贪官污吏
ztgql=提纲挈领
ztgnx=吐故纳新
ztgdh=天高地厚
ztgyh=韬光养晦
ztjhj=讨价还价
zdjjq=囤积居奇
ztjqq=投机取巧
ztjjr=推己及人
ztjmg=偷鸡摸狗
ztjzm=脱缰之马
ztjhh=啼饥号寒
ztjxs=投井下石
ztjbg=通今博古
ztkec=脱口而出
ztklt=痛哭流涕
ztmws=铁面无私
ztmbg=图谋不轨
ztpss=太平盛世
ztqtb=铜墙铁壁
ztqbj=图穷匕见
ztsec=挺身而出
ztswq=童叟无欺
ztsps=贪生怕死
ztscg=同室操戈
ztsxc=铁石心肠
ztskd=唾手可得
ztsjq=投鼠忌器
ztsyd=泰山压顶
ztszs=推三阻四
ztshb=兔死狐悲
ztsgp=兔死狗烹
ztsbd=泰山北斗
ztthg=脱胎换骨
zttbj=滔滔不绝
zttzz=堂堂正正
zttba=忐忑不安
zttyl=亭亭玉立
zttmm=偷偷摸摸
ztttt=吞吞吐吐
zttrw=体贴入微
zttbl=投桃报李
zttnr=头疼脑热
zttzg=贪天之功
ztthr=偷天换日
zttzl=推涛作浪
ztwbm=图文并茂
ztwwf=体无完肤
ztxdd=提心吊胆
ztxdd=通宵达旦
ztxjf=啼笑皆非
ztxzf=推心置腹
ztxdz=天旋地转
ztxsd=贪小失大
ztxbz=贪心不足
ztxdg=天悬地隔
ztxqy=偷香窃玉
ztyec=脱颖而出
ztyhj=天涯海角
ztywf=天衣无缝
ztyxm=徒有虚名
ztypd=糖衣炮弹
ztyjw=腾云驾雾
ztytw=吞云吐雾
ztymx=头晕目眩
ztymy=甜言蜜语
ztyjc=添油加醋
ztyzb=天渊之别
ztyxg=痛痒相关
ztzgj=同舟共济
ztzbq=停滞不前
ztzwf=贪赃枉法
ztzrh=天灾人祸
ztzjw=添砖加瓦
ztzyy=逃之夭夭
ztzjz=天之骄子
ztzmf=涂脂抹粉
ztzdm=天诛地灭
zdzzj=弹指之间
ztzts=徒子徒孙
ztzjy=添枝加叶
zwesw=望而生畏
zwebz=无恶不作
zwefy=忘恩负义
zwrwj=无人问津
zwrcf=蔚然成风
zwlst=唯利是图
zwryl=巍然屹立
zwrkx=万人空巷
zwrqt=误入歧途
zwnzs=污泥浊水
zwljj=万籁俱寂
zwlqn=无理取闹
zwlxs=未老先衰
zwrts=稳如泰山
zwnjh=万念俱灰
zwnms=未能免俗
zwrbc=挖肉补疮
zwrrs=惘然若失
zwrll=危如累卵
zwbsy=无病呻吟
zwbgz=完璧归赵
zwbxz=未卜先知
zwcbf=五彩缤纷
zwcmj=望尘莫及
zwcsq=稳操胜券
zwcqq=为丛驱雀
zwczy=无耻之尤
zwdyo=无独有偶
zwdyz=无动于衷
zwdzr=无地自容
zwdfs=无的放矢
zwdzz=歪打正着
zwdsc=五短身材
zwdbd=尾大不掉
zwhbm=五花八门
zwflj=违法乱纪
zwhsh=五湖四海
zwfsb=文房四宝
zwhwn=问寒问暖
zwfsd=闻风丧胆
zwfll=威风凛凛
zwfzd=为非作歹
zwfbr=为富不仁
zwhxy=物换星移
zwhzc=为虎作伥
zwfxj=枉费心机
zwhzz=乌合之众
zwhaz=呜呼哀哉
zwflm=瓦釜雷鸣
zwhzf=玩火自焚
zwfpm=望风披靡
zwfby=望风捕影
zwhsd=亡魂丧胆
zwgss=五光十色
zwgzx=温故知新
zwgsf=文过饰非
zwgty=无关痛痒
zwgzx=闻过则喜
zwgbh=顽固不化
zwgsl=无功受禄
zwjys=无济于事
zwjzb=无价之宝
zwjws=无拘无束
zwjks=无计可施
zwjzt=无稽之谈
zwjdc=无精打采
zwjqw=闻鸡起舞
zwjbc=无坚不摧
zwjbf=万劫不复
zwjbx=瓦解冰消
zwjzj=刎颈之交
zwknh=无可奈何
zwkfy=无可非议
zwkhf=无可厚非
zwkbr=无孔不入
zwkxs=挖空心思
zwkbn=无可比拟
zwkzb=无可争辩
zwkzy=无可置疑
zwkzd=纨绔子弟
zwmzc=无米之炊
zwmyx=无名英雄
zwmbt=万马奔腾
zwmxd=歪门邪道
zwmbz=萎靡不振
zwmzt=亡命之徒
zwmsc=唯命是从
zwmzk=望梅止渴
zwmqy=万马齐喑
zwply=威迫利诱
zwqwj=无穷无尽
zwqmm=温情脉脉
zwqzc=万全之策
zwqbz=污七八糟
zwssc=无所适从
zwswk=无时无刻
zwsjb=万事俱备
zwswx=无声无息
zwswj=无所畏惧
zwsbd=纹丝不动
zwsww=畏首畏尾
zwsbg=玩世不恭
zwsyh=握手言欢
zwswj=万寿无疆
zwsbc=万死不辞
zwtjl=味同嚼蜡
zwtwx=文恬武嬉
zwwey=温文尔雅
zwwdz=唯我独尊
zwwdg=蔚为大观
zwwbq=威武不屈
zwwnm=舞文弄墨
zwwsz=玩物丧志
zwwnn=唯唯诺诺
zwwdt=娓娓动听
zwwsq=文武双全
zwwzz=无妄之灾
zwwjz=围魏救赵
zwxws=我行我素
zwxcd=卧薪尝胆
zwxwk=问心无愧
zwxly=威胁利诱
zwxsd=威信扫地
zwxkc=无隙可乘
zwxch=妄下雌黄
zwxnb=蜗行牛步
zwyls=五颜六色
zwyxj=婉言谢绝
zwycm=未雨绸缪
zwylb=无与伦比
zwyzy=毋庸置疑
zwyst=危言耸听
zwywl=无忧无虑
zwywz=无影无踪
zwybl=亡羊补牢
zwyzq=乌烟瘴气
zwyhy=无庸讳言
zwywg=无缘无故
zwyhy=污言秽语
zwynf=外圆内方
zwylj=物以类聚
zwzyx=万众一心
zwzdx=危在旦夕
zwzqh=万紫千红
zwzwd=稳扎稳打
zwzbb=文质彬彬
zwzfb=妄自菲薄
zwzlf=五脏六腑
zwzzd=妄自尊大
zwzzb=瓮中捉鳖
zxewj=悬而未决
zxexh=小恩小惠
zxeby=学而不厌
zxegt=洗耳恭听
zxexy=响遏行云
zxlqb=星罗棋布
zxlys=训练有素
zxrdb=轩然大波
zxnal=喜怒哀乐
zxrkj=笑容可掬
zxrym=相濡以沫
zxlcb=兴利除弊
zxlsh=心领神会
zxlsq=心灵手巧
zxrhj=先人后己
zxljc=心力交瘁
zxlxf=狭路相逢
zxrhf=血肉横飞
zxrdg=心如刀割
zxnwc=喜怒无常
zxlrm=心乱如麻
zxrzb=霄壤之别
zxlhb=先礼后兵
zxnbl=徐娘半老
zxlcd=笑里藏刀
zxlys=星离雨散
zxlrz=心劳日拙
zxllp=惜老怜贫
zjlfh=降龙伏虎
zxbwl=下不为例
zxbzy=心不在焉
zxbyy=瑕不掩瑜
zxbxn=席不暇暖
zxbxj=虾兵蟹将
zxbxw=项背相望
zxbcz=下笔成章
zxcdx=新陈代谢
zxcww=喜出望外
zxcdl=雄才大略
zxcsw=心驰神往
zxcyx=响彻云霄
zxctj=喜从天降
zxcjh=新仇旧恨
zxcmr=心慈面软
zxctl=小丑跳梁
zxdyz=相得益彰
zxdez=席地而坐
zxdwk=先睹为快
zxdyz=形单影只
zxdjc=小肚鸡肠
zxdjl=心胆俱裂
zxdsc=心荡神驰
zxfxc=相辅相成
zxfzl=兴风作浪
zxhly=星火燎原
zxfzh=心腹之患
zxhrg=虚怀若谷
zxhwn=嘘寒问暖
zxfyl=心烦意乱
zxhsl=心狠手辣
zxfxy=腥风血雨
zxhyl=心灰意懒
zxhwl=寻花问柳
zxhsc=血海深仇
zxhyl=心慌意乱
zxhzt=绣花枕头
zxfcg=枵腹从公
zxhpc=心怀叵测
zxfgl=掀风鼓浪
zxgqy=心甘情愿
zxgcl=兴高采烈
zxgdj=循规蹈矩
zxgzx=学贯中西
zxghs=先公后私
zxgjd=寻根究底
zxgqa=心高气傲
zxgtp=心广体胖
zxjrf=心急如焚
zxjhl=心急火燎
zxjrt=心惊肉跳
zjjgt=解甲归田
zxjrb=相敬如宾
zxjby=小家碧玉
zxksy=心旷神怡
zxktp=心宽体胖
zxkch=信口雌黄
zxkpr=血口喷人
zxmyl=心明眼亮
zxmwd=邪门歪道
zxmyg=性命攸关
zxmyj=信马由缰
zxmzs=循名责实
zxmrj=惜墨如金
zxmsl=卸磨杀驴
zxpxl=嬉皮笑脸
zxpll=涎皮赖脸
zxqyy=喜气洋洋
zxqll=小巧玲珑
zxqxg=休戚相关
zxqlm=贤妻良母
zxqar=兴趣盎然
zxqyg=休戚与共
zxqyz=闲情逸致
zxqjy=虚情假意
zxswb=徇私舞弊
zxsjs=雪上加霜
zxsnj=销声匿迹
zxspg=袖手旁观
zxsdd=信誓旦旦
zxsnl=信手拈来
zxsbr=形势逼人
zxsdz=兴师动众
zxsnr=息事宁人
zxszr=行尸走肉
zxsdl=歇斯底里
zxses=凶神恶煞
zxswz=兴师问罪
zxskc=秀色可餐
zxsqg=仙山琼阁
zxsmh=寻死觅活
zxsbf=信赏必罚
zxtxd=谢天谢地
zxwlj=喜闻乐见
zxwpm=虚无缥缈
zxwsr=兴味索然
zxwhz=秀外慧中
zxwdm=胸无点墨
zxxss=形形色色
zxxxg=息息相关
zxxxr=欣欣向荣
zxxjj=循序渐进
zxxrs=栩栩如生
zxxrr=熙熙攘攘
zxxyy=小心翼翼
zxxzz=雄心壮志
zxxrk=欣喜若狂
zxxjc=相形见绌
zxxys=喜形于色
zxxsy=循循善诱
zxxyk=喜笑颜开
zxxlc=心血来潮
zxxxt=息息相通
zxxyj=喜新厌旧
zxxbl=凶相毕露
zxxgm=洗心革面
zxxss=相形失色
zxxys=晓行夜宿
zxxwy=纤悉无遗
zxxgl=形销骨立
zxxzt=惺惺作态
zxycz=胸有成竹
zxysx=休养生息
zxyfw=逍遥法外
zxyyj=心有余悸
zxycf=心悦诚服
zxycq=相映成趣
zxybl=形影不离
zxyqb=悬崖峭壁
zxylm=悬崖勒马
zxydz=星移斗转
zxyxf=血雨腥风
zxyxs=形影相随
zxyym=心猿意马
zxyyh=闲云野鹤
zxyws=虚与委蛇
zxyxd=形影相吊
zxylc=心余力绌
zxysb=膝痒搔背
zxyqb=虚有其表
zxyjs=炫玉贾石
zxzyx=行之有效
zxzbb=兴致勃勃
zxzst=雪中送炭
zxzgl=西装革履
zxzyk=笑逐颜开
zxzbx=心照不宣
zxzss=虚张声势
zxzmj=细枝末节
zxzlh=幸灾乐祸
zxzhz=先斩后奏
zxzyf=雄姿英发
zxzsl=削足适履
zxzml=细针密缕
zxzzj=寻章摘句
zxzyx=玄之又玄
zyece=以讹传讹
zyeys=隐恶扬善
zyedl=掩耳盗铃
zyedm=以耳代目
zyrjz=与日俱增
zyrej=迎刃而解
zylhz=鱼龙混杂
zylyy=一劳永逸
zynys=延年益寿
zyryy=游刃有余
zyljj=因陋就简
zyrrg=依然如故
zyrxm=音容笑貌
zyrey=因人而异
zyrzs=跃然纸上
zyrhg=雍容华贵
zyrjr=毅然决然
zyrws=与人为善
zylwy=一览无余
zylwh=以邻为壑
zyrzd=怡然自得
zylzd=夜郎自大
zyrem=掩人耳目
zyrgd=优柔寡断
zyrgw=依然故我
zynqj=一诺千金
zylyj=有棱有角
zyrsx=哑然失笑
zyrhh=杳如黄鹤
zylrs=引狼入室
zyryx=嫣然一笑
zyrzr=庸人自扰
zylml=倚老卖老
zyrzl=渔人之利
zylts=以卵投石
zyrks=贻人口实
zybrc=义不容辞
zybss=一波三折
zybzl=一臂之力
zybyq=亦步亦趋
zybyy=有板有眼
zybbn=欲罢不能
zybtd=一败涂地
zybwh=有备无患
zybgx=一笔勾销
zybyy=一板一眼
zybyz=言不由衷
zybkj=愚不可及
zybrs=用兵如神
zybxz=鹬蚌相争
zybyb=以暴易暴
zycej=一蹴而就
zycww=运筹帷幄
zycmz=一筹莫展
zycwg=腰缠万贯
zycbr=一尘不染
zycdy=一锤定音
zycbx=永垂不朽
zycjf=一触即发
zycxd=羊肠小道
zycsj=因材施教
zycml=寅吃卯粮
zycwn=遗臭万年
zycxh=野草闲花
zydzy=因地制宜
zydfs=有的放矢
zydsc=约定俗成
zydxs=异端邪说
zydzg=一定之规
zydsr=诱敌深入
zydby=以德报怨
zydwq=野调无腔
zyhcs=雨后春笋
zyhll=眼花缭乱
zyffs=一帆风顺
zyhxc=异乎寻常
zyfys=移风易俗
zyfsz=约法三章
zyfty=义愤填膺
zyfct=一反常态
zyfyw=阳奉阴违
zykgg=引吭高歌
zyhjm=移花接木
zyfzr=应付自如
zyhej=一挥而就
zyhss=引火烧身
zyhbs=阴魂不散
zyhyh=养虎遗患
zyhes=一哄而散
zyhnt=欲壑难填
zyfzh=扬幡招魂
zyhmp=与虎谋皮
zyfny=吟风弄月
zyfqj=一发千钧
zygzq=一鼓作气
zygys=愚公移山
zygel=一概而论
zygej=一干二净
zygyw=莺歌燕舞
zygcc=衣冠楚楚
zygmz=欲盖弥彰
zygbm=雁过拔毛
zyghx=以观后效
zygqs=衣冠禽兽
zyjtq=异军突起
zyjzc=一技之长
zyjbx=应接不暇
zyjbz=一蹶不振
zyjkc=有机可乘
zyjyg=言简意赅
zyjzq=一见钟情
zyjrg=一见如故
zyjjd=引经据典
zyjhx=衣锦还乡
zyjcx=一决雌雄
zyjcz=引咎辞职
zyjxy=以儆效尤
zyjxr=养精蓄锐
zyjsd=一箭双雕
zyjqx=一见倾心
zyjyq=业精于勤
zyjcy=殃及池鱼
zyjbq=玉洁冰清
zyjlz=冤家路窄
zykjb=有口皆碑
zykts=异口同声
zykwy=哑口无言
zykzj=一孔之见
zykqj=一刻千金
zymgd=有目共睹
zymjr=一鸣惊人
zymtq=扬眉吐气
zymhz=鱼目混珠
zymxc=一脉相承
zympc=一马平川
zymzc=揠苗助长
zymbb=一毛不拔
zymqy=缘木求鱼
zymsx=一目十行
zymqr=以貌取人
zymwf=羽毛未丰
zymxc=一脉相传
zypgq=以偏概全
zypss=一盘散沙
zyprx=一贫如洗
zyqhc=一气呵成
zyqtg=异曲同工
zyqbt=一窍不通
zyqeb=一穷二白
zyqxg=偃旗息鼓
zyqws=鸦雀无声
zyqnh=摇旗呐喊
zyqgz=欲擒故纵
zyqhd=油腔滑调
zyqzh=一丘之貉
zysbg=一丝不苟
zystr=一视同仁
zyszx=衣食住行
zysgs=雅俗共赏
zysyb=摇身一变
zysxz=以身殉职
zysrj=夜深人静
zyszd=怨声载道
zyswk=有恃无恐
zyssf=以身试法
zyscc=与世长辞
zysws=游山玩水
zysyh=一丝一毫
zyssy=饮水思源
zyshx=游手好闲
zysyz=有始有终
zysjf=玉石俱焚
zyswz=有始无终
zysqj=以售其奸
zysen=一石二鸟
zyszt=一手遮天
zysyg=疑神疑鬼
zysbk=一时半刻
zysdh=移山倒海
zyssm=仰首伸眉
zytbw=有条不紊
zytgs=迎头赶上
zytyr=怨天尤人
zytht=一塌糊涂
zytwf=仪态万方
zythn=摇头晃脑
zytzf=扬汤止沸
zyttj=迎头痛击
zytbw=摇头摆尾
zytyw=有头有尾
zythn=油头滑脑
zywzq=勇往直前
zywpd=夷为平地
zywyx=杳无音信
zywyw=耀武扬威
zywys=一五一十
zywjz=咬文嚼字
zywlc=语无伦次
zywxs=鹦鹉学舌
zywql=摇尾乞怜
zyxcc=忧心忡忡
zyxfz=浴血奋战
zyxsj=因循守旧
zyxtk=异想天开
zyxrf=忧心如焚
zyxys=烟消云散
zyxyr=有血有肉
zyxql=一泻千里
zyxmm=隐姓埋名
zyxbl=原形毕露
zyxsc=一息尚存
zyxdf=贻笑大方
zyxbb=野心勃勃
zyxjf=严刑峻法
zyxkc=有隙可乘
zyxws=云消雾散
zyyjq=一应俱全
zyyys=跃跃欲试
zyycc=郁郁葱葱
zyyyx=奄奄一息
zyybs=依依不舍
zyyes=一拥而上
zyybj=犹豫不决
zyywj=引以为戒
zyyyz=摇摇欲坠
zyyfs=因噎废食
zyydc=抑扬顿挫
zyycc=影影绰绰
zyyqc=咬牙切齿
zyyze=言犹在耳
zyybx=语焉不详
zyygh=郁郁寡欢
zyyrl=余音绕梁
zyydl=以逸待劳
zyyjd=一言九鼎
zyyzz=引玉之砖
zyybf=要言不烦
zyywm=有勇无谋
zyyhz=妖言惑众
zyygg=蝇营狗苟
zyygh=抑郁寡欢
zyykj=余勇可贾
zyyqc=隐约其辞
zyybd=以怨报德
zyysf=一隅三反
zyzbt=与众不同
zyzqj=一掷千金
zyzkw=一纸空文
zyzdp=越俎代庖
zyzzk=饮鸩止渴
zyzcy=养尊处优
zyzqs=颐指气使
zyzbb=睚眦必报
zyzyb=一字一板
zyzhl=一枕黄粱
zyzqt=一柱擎天
zyzhs=油嘴滑舌
zzeyl=震耳欲聋
zzedd=作恶多端
zzebq=卓尔不群
zzens=抓耳挠腮
zzett=罪恶滔天
zzltj=崭露头角
zzrwl=助人为乐
zzncb=走南闯北
zzlps=支离破碎
zzrww=置若罔闻
zzlbh=珠联璧合
zzlwz=杂乱无章
zzldz=中流砥柱
zzlfk=振聋发聩
zzlbd=坐冷板凳
zzrsr=知人善任
zzlzy=逐鹿中原
zzrrj=昭然若揭
zznjj=钻牛角尖
zclxg=朝令夕改
zzlyx=钟灵毓秀
zznsz=罪孽深重
zzlzy=装聋作哑
zzrem=遮人耳目
zznnf=众怒难犯
zzbjk=赞不绝口
zzbsn=中饱私囊
zzbmm=招兵买马
zzbzq=自暴自弃
zzbxk=照本宣科
zcbbx=朝不保夕
zzbsg=作壁上观
zzbqy=追本穷源
zzbzb=追奔逐北
zzcxh=自惭形秽
zzcdc=铸成大错
zzczl=自吹自擂
zzcty=咫尺天涯
zzcjz=自出机杼
zzdjt=斩钉截铁
zzdjc=张灯结彩
zzdej=罪大恶极
zzdcs=志大才疏
zzdys=植党营私
zzdrq=煮豆燃萁
zzdfz=坐地分赃
zzhjc=纵横交错
zzfxd=针锋相对
zzfym=枝繁叶茂
zzfmy=栉风沐雨
zzhbh=纵横捭阖
zzhmj=追悔莫及
zzfrs=执法如山
zzfff=知法犯法
zzfcc=争风吃醋
zcfxz=朝发夕至
zzfms=装疯卖傻
zzhbh=专横跋扈
zzhzz=贼喊捉贼
zzhfq=煮鹤焚琴
zzfzb=作法自毙
zzgzw=载歌载舞
zzgfy=自告奋勇
zzgyp=左顾右盼
zzgbq=珠光宝气
zzgmt=砸锅卖铁
zzgld=张冠李戴
zzgqy=趾高气扬
zzgjd=追根究底
zzgbx=自顾不暇
zzgdd=枕戈待旦
zzgws=罪该万死
zzjzl=再接再厉
zzjjz=捉襟见肘
zzjld=直截了当
zzjnt=在劫难逃
zzjzb=知己知彼
zzjzf=作茧自缚
zzjwz=正襟危坐
zzjgt=坐井观天
zzkyc=众口一词
zzkhs=罪魁祸首
zzknd=众口难调
zzkbr=自愧不如
zzkjs=张口结舌
zzksj=众口铄金
zzmkk=众目睽睽
zzmbw=执迷不悟
zzmzy=装模作样
zzmhh=照猫画虎
zzmdy=自鸣得意
zzmds=钟鸣鼎食
zzmsy=贼眉鼠眼
zzmzz=众目昭彰
zzpsj=真凭实据
zzpql=众叛亲离
zzqbx=自强不息
zcqpb=朝气蓬勃
zzqqr=自欺欺人
zzqgh=瞻前顾后
zzqys=珍禽异兽
zzqzs=装腔作势
zzqdg=沾亲带故
zzqmw=自取灭亡
zcqmc=朝秦暮楚
zzqyj=众擎易举
zzqnh=招权纳贿
zzszz=众所周知
zzsfy=众说纷纭
zzszz=自始至终
zzsnm=在所难免
zzstb=纸上谈兵
zzskr=炙手可热
zzsql=自食其力
zzszm=自生自灭
zzsrr=志士仁人
zzsmj=蛛丝马迹
zzsbx=在所不惜
zcsmx=朝思暮想
zzszl=自私自利
zzszd=众矢之的
zzsqg=自食其果
zzsyl=坐收渔利
zzsec=择善而从
zzsjj=直抒己见
zzsms=醉生梦死
zzsbc=在所不辞
zzsqr=仗势欺人
zcsms=朝三暮四
zzssw=置身事外
zzsmh=指桑骂槐
zzssd=粥少僧多
zzsqy=自食其言
zzsdm=筑室道谋
zzsbj=坐视不救
zztgz=债台高筑
zztkc=自讨苦吃
zztdd=震天动地
zztgd=遮天盖地
zztzn=贼头贼脑
zztsr=指天誓日
zztsm=獐头鼠目
zzwpd=责无旁贷
zzwxx=座无虚席
zzwwa=转危为安
zzwsg=众望所归
zzwmj=转弯抹角
zzwzf=作威作福
zzwqc=支吾其词
zzwmb=真伪莫辨
zzxkh=争先恐后
zzxcs=自相残杀
zzxgg=忠心耿耿
zzxwy=子虚乌有
zzxmd=自相矛盾
zzxpy=众星捧月
zzxqc=坐享其成
zzjnp=招降纳叛
zzycx=卓有成效
zzybh=直言不讳
zzyfy=左右逢源
zzydb=坐以待毙
zzyzp=招摇撞骗
zzyyd=罪有应得
zzywz=张牙舞爪
zzyzd=中庸之道
zzyhz=造谣惑众
zzysc=仗义疏财
zzyne=忠言逆耳
zzyyr=珠圆玉润
zzywn=质疑问难
zzyls=正颜厉色
zzyza=自怨自艾
zzyjh=直言贾祸
zzzrs=蒸蒸日上
zzzbj=孜孜不倦
zzzzx=沾沾自喜
zzzzj=真知灼见
zzzcc=众志成城
zzzcx=只争朝夕
zzzbl=置之不理
zzzdw=置之度外
znzfc=辗转反侧
zzzjj=战战兢兢
zzzdf=整装待发
zzzqs=郑重其事
zzzjz=字斟句酌
zzzba=惴惴不安
zzzby=忠贞不渝
zzzwc=壮志未酬
zzzwn=助纣为虐
zzzdm=足智多谋
zzzxx=做贼心虚
zzzjm=纸醉金迷
zzzcm=自作聪明
zzzly=壮志凌云
zzznh=置之脑后
zzzyc=左支右绌
znzxs=囊中羞涩
zlsfc=露宿风餐
zbprl=鞭辟入里
zbwxg=薄物细故
zbbby=褒贬不一
zsswd=熟视无睹
zytxl=蝇头小利
zfszw=蜚声中外
zjmjl=精妙绝伦
zldsq=零打碎敲
zlqbs=零七八碎
zzzbj=锱铢必较
zjxhs=锦绣河山
zjqjz=畸轻畸重
zccbj=愁肠百结
zqsba=寝食不安
zsjmn=释迦牟尼
zjtxy=街谈巷议
zqsyd=翘首以待
ztywj=童言无忌
ztxwm=童心未泯
zsxyc=稍逊一筹
zhydk=皓月当空
zdtrs=登堂入室
zqjyy=琼浆玉液
zqqsh=琴棋书画
zkyyx=溃于蚁穴
zzysq=智勇双全
zzzjz=智者见智
zjytt=晶莹剔透
zjxbm=敬谢不敏
zccnf=插翅难飞
zrssf=惹事生非
zxhwf=循环往复
zzyye=属垣有耳
zxbzs=喜不自胜
zsjry=善解人意
zslrw=萨拉热窝
zljyb=略见一斑
zhsmw=混世魔王
zhlbs=毫厘不爽
zdycb=断垣残壁
zdxfz=断线风筝
zjrez=戛然而止
zwmwx=惟妙惟肖
zqdck=情窦初开
zyrzd=悠然自得
zmyby=密云不雨
zgpzx=顾盼自雄
zjzfb=酒足饭饱
zptcl=配套成龙
zzyzs=造谣中伤
zhyfq=获益匪浅
zmmqm=莫明其妙
zjlmg=紧锣密鼓
zxyrh=笑靥如花
zhrzq=浩然之气
zthll=桃红柳绿
zjabx=桀骜不驯
zpqcj=旁敲侧击
znybh=捏一把汗
zzzyc=振振有辞
zsbfp=恕不奉陪
zjtsb=家徒四壁
zcqsj=唇枪舌剑
zqgqc=倾国倾城
zygzs=倚官仗势
zfsjs=俯拾皆是
zsszq=首善之区
zzyts=重于泰山
zzbsy=追本溯源
zyhwq=贻害无穷
zdxrs=胆小如鼠
zmlmh=美轮美奂
zjcfs=绝处逢生
zhshy=绘声绘影
zjjys=炯炯有神
zxjyk=洗劫一空
zcqbq=残缺不全
zzfwh=指腹为婚
zzhrd=指挥若定
zczyg=持之有故
zhhss=恒河沙数
zscqf=思潮起伏
zdzgz=待字闺中
zlsxd=孪生兄弟
zcxtx=促膝谈心
zjszl=举手之劳
zbjcs=饱经沧桑
zjgyq=降格以求
zqqjl=茕茕孑立
zyzss=英姿飒爽
zfplc=肤皮潦草
zkkwp=空口无凭
zhfys=环肥燕瘦
zywyx=杳无音讯
zmxzd=明修栈道
zbyjr=拨云见日
zcmjx=怵目惊心
zhzgj=和衷共济
zgrbh=供认不讳
zjpgd=鸡皮疙瘩
zaspl=阿司匹林
zptpz=评头品足
zcscb=苍松翠柏
zhhsj=花花世界
znznb=男尊女卑
zwyql=沃野千里
zjlsj=极乐世界
zlqcc=来去匆匆
ztflx=条分缕析
zgsyc=更胜一筹
znybl=拟于不伦
zjbsy=戒备森严
zygym=忧国忧民
zzhsc=张皇失措
zzzyq=孜孜以求
zdxjn=妒贤嫉能
zssqm=声色犬马
zjcby=坚持不渝
zchzl=吹灰之力
zhhqc=含糊其词
zhxpr=含血喷人
zbyfw=别有风味
zprlr=判若两人
zhzgc=何足挂齿
zbzzj=伯仲之间
zycbd=严惩不贷
zbmys=百密一疏
zbbtt=百般挑剔
zbfjx=百废俱兴
zbwjj=百无禁忌
zbcgh=百川归海
zscld=死缠烂打
zzqzb=杂七杂八
zcjfr=成绩斐然
zczzx=成竹在胸
zrmkz=戎马倥偬
zrjzx=如箭在弦
zrlbb=如履薄冰
zrlsy=如临深渊
ztcyz=同出一辙
ztgyq=同工异曲
zjgpy=吉光片羽
zclpw=吃里爬外
zbxwj=冰消瓦解
zyzyz=优哉游哉
zylsb=伊丽莎白
zqqzx=乔迁之喜
zssqc=闪烁其词
zlzzd=立锥之地
zlccz=立此存照
zlgsz=立功赎罪
zmbxs=目不斜视
zbbwx=白璧微瑕
zggjd=归根结蒂
znqwl=宁缺勿滥
znybx=奴颜婢膝
zylxm=以泪洗面
zylxd=以礼相待
zdgxs=东郭先生
zwbsj=韦编三绝
zctbs=长途跋涉
zjlxx=见猎心喜
zjwsm=见危授命
zjfzd=见风转舵
zhsyh=火树银花
zqyxa=气宇轩昂
zwyzy=无庸置疑
zdzxy=斗转星移
zklxf=开路先锋
zfmcc=反目成仇
zjryx=井然有序
zyqyq=予取予求
zwqbz=乌七八糟
zwgjq=为国捐躯
zbxzz=不祥之兆
zbrzy=不容置疑
zbjrl=不绝如缕
zbjye=不绝于耳
zbzsz=不知所终
zbzwp=不足为凭
zbkpf=不可偏废
zjgyx=巾帼英雄
zsgwh=尸骨未寒
zswsc=尸位素餐
zxkzj=小康之家
zcysc=寸有所长
zdhlz=大海捞针
zdfyc=大放异彩
zdqbb=大气磅礴
zdkyj=大开眼界
zqhwh=千呼万唤
zjfsm=久负盛名
zscxt=上窜下跳
zsjqk=三缄其口
zylbz=一鳞半爪
zypsh=一暴十寒
zytht=一塌胡涂
zyxqy=一厢情愿
zyyzm=一叶障目

