zaiai=皑皑
zaie=挨饿
zangran=盎然
zanran=黯然
zaonao=懊恼
zanlian=谙练
zerlong=耳聋
zeran=愕然
zlianai=恋爱
zrenai=仁爱
zniai=溺爱
zniaor=鸟儿
zniuer=牛耳
zlirun=利润
zneilu=内陆
zrenao=热闹
zrongna=容纳
zroulei=肉类
zlaolao=牢牢
zlailin=来临
zlunli=伦理
zniurou=牛肉
zraoluan=扰乱
zlaoling=老龄
zlinglve=领略
zlaolei=劳累
zliulang=流浪
zlinli=邻里
zrouruan=柔软
zrongli=荣立
zranliao=染料
zlieri=烈日
zliulu=流露
zniaolei=鸟类
zlinan=罹难
zrongren=容忍
zruanruo=软弱
znuli=奴隶
zlonglong=隆隆
zrelang=热浪
znirong=呢绒
znanlan=男篮
zlengnuan=冷暖
znining=泥泞
zlulu=陆路
zliulan=浏览
zranran=冉冉
zluolu=裸露
zliaoliao=寥寥
znonglie=浓烈
znaire=耐热
zliulian=留恋
zrennai=忍耐
zlianren=恋人
zlinli=淋漓
zlinlie=凛冽
zrongru=荣辱
znengnai=能耐
zlaolao=姥姥
zlalian=拉链
zrenling=认领
zleling=勒令
zliaoliang=嘹亮
zlieren=猎人
znaili=耐力
znannan=喃喃
zlinglong=玲珑
zliaorao=缭绕
znanlu=南麓
zlanglang=朗朗
znuanliu=暖流
zniliu=逆流
znannai=难耐
zlinran=凛然
zlengning=冷凝
zlalong=拉拢
zronglu=熔炉
zroulin=蹂躏
znaliang=纳凉
zruili=锐利
zniaoniao=袅袅
zrelian=热恋
znongnu=农奴
zlingru=凌辱
zlurong=鹿茸
znaoli=脑力
zlilin=莅临
zlingli=凌厉
zlanni=烂泥
zlaran=蜡染
zliliao=理疗
zrangrang=嚷嚷
znenlv=嫩绿
zlanlu=拦路
zrenran=荏苒
zruniu=乳牛
zlunluo=沦落
zlvli=履历
zrouren=柔韧
zlingluan=凌乱
zlaolong=牢笼
znailao=奶酪
znuoruo=懦弱
zlaolu=劳碌
znaoren=恼人
zlingli=伶俐
zninao=泥淖
zliren=利刃
zlianru=炼乳
zliangnv=靓女
znaonu=恼怒
zrongren=荣任
zlilu=利禄
zlarou=腊肉
zlirang=礼让
zlongluo=笼络
zlinle=临了
zrounen=柔嫩
zluanlun=乱伦
zliaoluo=寥落
zrulian=入殓
zlulu=辘轳
zraolu=绕路
zniunie=扭捏
zlienv=烈女
zlou0luo=喽罗
zlinglang=令郎
zlianou=莲藕
zouer=偶尔
zouran=偶然
zaibian=癌变
zanban=案板
zeba=恶霸
zlaoban=老板
zlianbang=联邦
zningbo=宁波
zlaoban=老伴
zlaba=喇叭
zluobo=萝卜
zlaobao=劳保
zlubu=卢布
zliebian=裂变
zlianbing=练兵
zlinba=淋巴
zlibi=利弊
zlibai=礼拜
zlinbie=临别
zlinbang=邻邦
zliba=篱笆
zlubiao=路标
zluobang=落榜
zniaobu=尿布
zlouban=楼板
zniba=泥巴
zlangbei=狼狈
zlingban=领班
zlanben=蓝本
zliangban=凉拌
zranbing=染病
zlanbu=滥捕
zrubai=乳白
zlaobing=烙饼
zlaobei=老辈
zliubing=溜冰
zliaobo=撩拨
zlianbo=联播
zlvban=旅伴
znubi=奴婢
zniban=拟办
zlabi=蜡笔
znongbao=脓包
zanchun=鹌鹑
zanchang=暗娼
zancang=暗藏
zancha=安插
zaichou=哀愁
zenci=恩赐
zechuan=讹传
zlinchuang=临床
zlicheng=历程
zrechao=热潮
zlingchen=凌晨
zliucheng=流程
zlangchao=浪潮
zlicheng=里程
zluchu=露出
zricheng=日程
znicha=逆差
zlengcang=冷藏
zlucheng=路程
zniangcheng=酿成
zliuchang=流畅
zliangcang=粮仓
zliangce=良策
zlvcha=绿茶
zrecheng=热诚
zliaocheng=疗程
znacui=纳粹
zlvcheng=旅程
zlicai=理睬
zliucuan=流窜
zluanchao=卵巢
zlinchang=临场
zningcheng=凝成
zlingchang=领唱
zrenci=仁慈
zlache=拉扯
zleichi=雷池
zruchuang=褥疮
znaicha=奶茶
zliancai=敛财
zlanche=缆车
zrongchang=冗长
zluochao=落潮
zliaocao=潦草
zliangcai=凉菜
zlianchi=廉耻
zroucuo=揉搓
zrouchang=柔肠
znucai=奴才
zliangchen=良辰
znanchan=难缠
zlaochao=老巢
znicheng=昵称
znuchi=怒斥
znance=男厕
zlunchang=伦常
zniaochuang=尿床
zlachang=腊肠
znuchao=怒潮
zlingchi=凌迟
zluanchuang=乱闯
zlanchong=懒虫
znuchi=怒叱
zaida=挨打
zaidao=哀悼
zandan=黯淡
zerduo=耳朵
zedu=恶毒
zende=恩德
zendian=恩典
zlingdao=领导
zlaodong=劳动
zruidian=瑞典
zlongduan=垄断
zlundun=伦敦
zniudai=纽带
znongdu=浓度
zleida=雷达
zlengdong=冷冻
zniding=拟定
zloudong=漏洞
zludi=陆地
znaodai=脑袋
zlingdian=零点
zlveduo=掠夺
znvedai=虐待
zlingdai=领带
zlingdui=领队
zlvdian=旅店
zlvdou=绿豆
zniding=拟订
zruoda=偌大
zliangduan=两端
zlongdong=隆冬
zliangdu=亮度
zlundu=轮渡
zraodao=绕道
zlingdi=领地
zlodou=漏斗
zluoding=螺钉
zniandao=念叨
zloudian=漏电
zleidian=雷电
zlvedai=略带
zliandao=镰刀
zrudong=蠕动
zniaodao=尿道
zlande=懒得
zlaodi=老弟
zlaodun=劳顿
zlanduo=懒惰
zlaodao=唠叨
zlangdu=朗读
znuodong=挪动
zrendai=韧带
zlingdu=零度
znongdan=浓淡
zliaodao=潦倒
zliedeng=劣等
zlingcheng=铃铛
zrandian=燃点
zniuda=扭打
zniudu=牛犊
zlangdang=浪荡
zloudi=露底
zludun=鲁钝
zouda=殴打
zanhui=安徽
zaihu=爱护
zanfan=案犯
zanfu=安抚
zaifu=爱抚
zaohui=懊悔
zaihao=哀号
zehua=恶化
zehao=噩耗
zerhuan=耳环
zehuang=鹅黄
zenhui=恩惠
znengfou=能否
zronghuo=荣获
zlangfei=浪费
zneihan=内涵
zleifeng=雷锋
zlinghun=灵魂
znonghou=浓厚
zlanhua=兰花
znanhai=男孩
zliaofa=疗法
zlinghui=领会
znenghao=能耗
znaihuo=耐火
zrunhua=润滑
zlihai=厉害
zlianhua=莲花
zlianhuan=联欢
znaohai=脑海
zliefeng=裂缝
zlaihan=来函
znianhuo=年货
zlihui=例会
zronghua=熔化
zranfang=燃放
zliehuo=烈火
znahan=呐喊
zronghua=荣华
zlihua=礼花
zruanhua=软化
zlunfan=轮番
zlinghai=领海
zlanghua=浪花
zlifu=礼服
zneihao=内耗
zrufang=乳房
znuanhuo=暖和
znaihe=奈何
znaifan=耐烦
zlaofang=牢房
znaohuo=恼火
zliangfeng=凉风
zlenghan=冷汗
zliehen=裂痕
znaihan=耐寒
zronghua=溶化
znuhou=怒吼
zlinghang=领航
zleihen=泪痕
zlvfei=旅费
zliangfen=凉粉
zluhua=芦花
zlanhan=懒汉
znuhua=奴化
znifeng=逆风
znuofu=懦夫
zlahuang=蜡黄
zrefu=热敷
zneihong=内讧
zleifan=累犯
znaofan=闹翻
zlifa=礼法
zrehuo=惹祸
znifan=腻烦
znuanhu=暖壶
znianfu=黏附
zoufa=偶发
zouhe=偶合
zanggui=昂贵
zangang=鞍钢
zaogu=傲骨
zangou=暗沟
zaigao=哀告
zaige=哀歌
zeguo=恶果
zerguang=耳光
zegun=恶棍
zergen=耳根
zegui=恶鬼
zegan=恶感
zlaogong=劳工
zneige=内阁
zlaogu=牢固
zlvguan=旅馆
zlinguo=邻国
zninggu=凝固
zlaigao=来稿
zlaogai=劳改
zluogu=锣鼓
zlianguan=连贯
zlangan=栏杆
zlveguo=掠过
znangua=南瓜
zleiguan=雷管
zlugu=颅骨
zlanggou=狼狗
zruangu=软骨
zliangguang=亮光
znaogua=脑瓜
zrugu=如故
zleigong=雷公
zlugu=露骨
zlinggong=零工
zligui=立柜
zruangao=软膏
zrangang=染缸
zniangao=年糕
znigao=拟稿
zligui=例规
zronggui=荣归
zliegou=猎狗
zrougan=肉感
zluoguo=罗锅
znaogui=闹鬼
zlagou=拉钩
zouge=讴歌
zaiji=埃及
zanjing=安静
zanjian=按键
zanjiao=暗礁
zaijin=挨近
zaijiao=哀叫
zerji=耳机
zerji=耳际
zeji=恶疾
zruanjian=软件
zlaji=垃圾
zluoji=逻辑
zningju=凝聚
zlianjie=廉洁
zlingjian=零件
zlengjing=冷静
zlianjia=廉价
zrujia=儒家
zlajiao=辣椒
zlinju=邻居
zniangjiu=酿酒
zliangjie=谅解
zlinjin=临近
zlinjin=邻近
znaojin=脑筋
zlujun=陆军
zlaoji=牢记
zningjing=宁静
zlingjiang=领奖
zrongjie=溶解
zlaojiao=劳教
zleiji=累积
zruijian=锐减
zningjie=凝结
znanjiang=南疆
zrongji=溶剂
zrongji=容积
znianjian=年鉴
znijing=逆境
znijiang=泥浆
zlujing=路径
zlongjing=龙井
zlijie=礼节
zlanjie=拦截
zneijiu=内疚
znveji=疟疾
zlvju=旅居
zlijin=礼金
znaijiu=耐久
znaoju=闹剧
zlianjia=脸颊
zlengjun=冷峻
zlijiao=礼教
zlingjia=凌驾
zlijing=离境
zliji=痢疾
zlingjiu=灵柩
zlaojian=老茧
zlieji=劣迹
zlingjiao=领教
zrujiao=乳胶
zleiji=雷击
zlangji=狼藉
zlengjiao=棱角
zruanjin=软禁
zlinjie=邻接
zrujiang=儒将
zlijia=例假
zrenjuan=认捐
zlingjiao=菱角
zlangjun=郎君
zneijian=内奸
zlingjian=令箭
zlingjie=领结
zliujin=镏金
zrongjie=熔解
zliaoji=僚机
zlaojia=劳驾
zlengjian=冷箭
zaokou=拗口
zlvke=旅客
zlike=立刻
zniukui=扭亏
znongken=农垦
zliaokuo=辽阔
zrikou=日寇
zlunkuo=轮廓
znangkuo=囊括
zniukou=纽扣
zlaoku=劳苦
zlingkong=领空
zlingkong=凌空
znankan=难堪
zlengku=冷酷
zliekai=裂开
zniaokan=鸟瞰
zrenke=任课
zluokuang=箩筐
zlaokao=牢靠
zlingkou=领口
zliekou=裂口
znikeng=泥坑
zloukong=镂空
zliangkuai=凉快
znaoke=脑壳
zlikui=理亏
zliaokao=镣铐
zrongku=绒裤
zanmo=按摩
zaomi=奥秘
zaomiao=奥妙
zaoman=傲慢
zaimu=爱慕
zanmian=安眠
zaima=挨骂
zaimei=暧昧
zanmi=安谧
zaiming=哀鸣
zemo=恶魔
zermu=耳目
zemao=鹅毛
zemeng=噩梦
zeming=恶名
zneimeng=内蒙
zlimi=厘米
znanmian=难免
zlanmu=栏目
zlaomo=劳模
zrenmian=任免
zliming=黎明
zlangman=浪漫
zliumang=流氓
zlimao=礼貌
zlingmin=灵敏
zloumian=露面
znaimo=耐磨
zneimu=内幕
znianmai=年迈
zlengmo=冷漠
zningmeng=柠檬
zlama=喇嘛
zzhanmo=粘膜
zleiming=雷鸣
zlinmo=临摹
zluomu=螺母
zrongmao=容貌
znamen=纳闷
zrongmao=绒毛
zlingmu=陵墓
zluomu=落幕
zrongma=戎马
zlimao=礼帽
zlianmin=怜悯
zlanman=烂漫
zluoma=骡马
zruma=辱骂
zlamei=腊梅
znaomen=脑门
zlimin=黎民
zniming=匿名
znongmi=浓密
zniumao=牛毛
zruming=乳名
zluomao=螺帽
zlumang=鲁莽
zluomo=落寞
zrumu=乳母
zrouma=肉麻
zliumei=柳眉
zoumu=欧姆
zanpei=安培
zlipin=礼品
zliangpang=两旁
zruanpan=软盘
zlaopo=老婆
zrenping=任凭
zlipao=礼炮
zlianpang=脸庞
zniupeng=牛棚
zlipu=离谱
zlianpu=脸谱
zlinpian=鳞片
znianpu=年谱
zluopo=落魄
zlianpeng=莲蓬
znupu=奴仆
zliangpeng=凉棚
zlinpen=临盆
zlaipi=赖皮
zaiqiu=哀求
zaoqi=傲气
zaiqi=哀泣
zenqing=恩情
zriqu=日趋
zlingqu=领取
zrongqi=容器
zlanqiu=篮球
zniuqu=扭曲
zlequ=乐趣
zliqing=沥青
znuanqi=暖气
zrongqia=融洽
zlongqi=隆起
zlieqiang=猎枪
zlingqian=零钱
zlingqiao=灵巧
zlaoqian=捞钱
zliangqi=两栖
zlouqi=漏气
zliequ=猎取
zlianqiu=链球
zlvequ=略去
zruiqi=锐气
zlaoqu=捞取
zleiqiu=垒球
zniqiu=泥鳅
zlianqing=恋情
zneiqin=内勤
zliaoqiao=料峭
zliangqiang=踉跄
zlingqin=陵寝
zliangqi=凉气
zliangqi=两讫
zlanquan=揽权
zliqu=理屈
zliqi=离弃
zangsi=盎司
zaisi=哀思
zaoshi=傲视
zanshu=谙熟
zaosang=懊丧
zaishang=哀伤
zaishi=碍事
zanshi=安适
zansuo=暗锁
zesha=扼杀
zeshou=扼守
zrenshi=认识
zliangshi=粮食
zlingshou=零售
zlvshi=律师
zlinshi=临时
zliansuo=连锁
znashui=纳税
zruishi=瑞士
zlunshu=论述
zlieshi=烈士
zranshao=燃烧
zlasa=拉萨
zlanse=蓝色
zlishu=隶属
zliansai=联赛
zlaoshu=老鼠
zlushan=庐山
zlieshi=劣势
zloushui=漏税
znisha=泥沙
znongsuo=浓缩
zranse=染色
zroushi=肉食
znaoshi=闹市
zlvshun=旅顺
zlashen=拉伸
zlingsan=零散
zliangshuang=凉爽
zliangshui=凉水
zrenshen=妊娠
znaoshi=闹事
zliusu=流速
zlvshe=旅社
zliushi=流逝
znansong=南宋
zlingshi=领事
zlieshu=烈属
zlaosao=牢骚
zlangsong=朗诵
zningshi=凝视
zliushu=柳树
zlisan=离散
znisu=泥塑
zluosi=螺丝
zlesuo=勒索
zlingshi=零时
zliangshai=晾晒
zluanshi=卵石
zlushui=露水
zlisuo=利索
zlingsui=零碎
zlunsang=沦丧
zlusu=露宿
zlingshi=零食
zluansheng=孪生
zningshen=凝神
zlishu=隶书
zlaoshuai=老帅
zlinse=吝啬
zrunshi=润湿
zniusong=扭送
zlansan=懒散
zrenshu=认输
zleisheng=雷声
zlisheng=厉声
zlinsi=临死
zlingshou=领受
zlousu=陋俗
zlansheng=缆绳
zrongshu=榕树
zrunse=润色
zlanshu=烂熟
znuanse=暖色
zlvshi=律诗
znishui=逆水
zlieshou=猎手
zlaoshen=劳神
zruoshi=弱视
zruanshui=软水
zreshi=惹事
zrongshen=容身
zningsi=凝思
zlishi=立誓
zrouse=肉色
zrishi=日食
znisi=溺死
zrusheng=儒生
zraoshe=饶舌
zraoshu=饶恕
zlasuo=拉锁
zlashou=辣手
zlishu=礼数
zlisu=俚俗
zrunshi=润饰
zoushu=偶数
zantai=安泰
zaotu=凹凸
zaitan=哀叹
zaitong=哀痛
zantan=暗滩
zantan=暗探
zluntai=轮胎
zlingtu=领土
zluntan=论坛
zlantu=蓝图
zlantian=蓝天
zlutian=露天
zlitang=礼堂
znitu=泥土
zluotuo=骆驼
zleitai=擂台
zlingtou=领头
zlvtu=旅途
zliaotian=聊天
zliantiao=链条
zliutang=流淌
zlouti=楼梯
zlingting=聆听
zrouti=肉体
zlutu=路途
zlongtong=笼统
zleitong=雷同
zluoti=裸体
zlingtang=灵堂
zleitui=类推
znitan=泥潭
zlantan=篮坛
znaitang=奶糖
zlangtou=浪头
zlaotie=烙铁
zlingtou=零头
zlangtao=浪涛
zleiting=雷霆
zliutiao=柳条
zliangtang=亮堂
znaoteng=闹腾
zliangting=凉亭
zlangtou=榔头
zliti=例题
zniangtai=娘胎
zruanti=软梯
zliangtai=凉台
zlvetu=略图
zlingtang=令堂
znutao=怒涛
zniantu=黏土
zoutu=呕吐
zanwei=安慰
zanwei=安危
zanwen=安稳
zaiwan=哀婉
zerwen=耳闻
zewan=扼腕
zlaowu=劳务
znuowei=挪威
zliwai=例外
zlaowo=老挝
zliwu=礼物
zliewen=裂纹
zluowen=螺纹
zlingwu=领悟
zlunwei=沦为
zluowu=落伍
zluwei=芦苇
zliuwang=流亡
zningwang=凝望
zlvewei=略为
zliewu=猎物
zlaoweng=老翁
zlianwu=练武
zlouwang=漏网
zlvewei=略微
zruanwo=软卧
znanwei=南纬
zniwei=腻味
zluwei=卤味
zlawan=蜡丸
zraowan=绕弯
zaixi=爱惜
zanxi=安息
zaoxiang=翱翔
zaixiao=矮小
zaoxian=凹陷
zanxian=安闲
zanxi=暗喜
zanxie=安歇
zexing=恶性
zexin=恶心
zexi=恶习
zlianxu=连续
zlvxing=履行
zleixing=类型
zlingxian=领先
zluxu=陆续
zningxia=宁夏
zlixi=利息
zliaoxiao=疗效
zlvxing=旅行
zlingxiu=领袖
znaixin=耐心
zliangxiang=亮相
zluoxuan=螺旋
zlingxing=零星
zliexi=列席
zrenxing=韧性
zlingxia=零下
zrongxing=荣幸
zliangxie=凉鞋
zlaxiang=蜡像
zlinxing=临行
znongxian=农闲
znixiang=逆向
zlingxian=领衔
zrongxu=容许
zlixing=例行
zlunxian=沦陷
zliangxing=量刑
zliexi=裂隙
zliexing=烈性
zlouxi=陋习
znianxi=年息
zrongxian=绒线
zrangxian=让贤
zlixian=历险
zlingxing=菱形
zruixue=瑞雪
zlinxi=吝惜
zlixian=立宪
zraoxing=绕行
zlinxun=嶙峋
zlaoxin=劳心
znixing=逆行
znaixing=耐性
zliuxu=柳絮
zlixia=立夏
zliuxie=流泻
zrenxiong=仁兄
zningxiao=狞笑
zlianxi=怜惜
zlaoxiu=老朽
zruanxi=软席
zneixiang=内详
zouxiang=偶像
zaoyun=奥运
zaoyou=遨游
zanyi=安逸
zangyang=昂扬
zaiya=哎呀
zaoye=熬夜
zaiyuan=哀怨
zaiyo=哎哟
zaiyan=碍眼
zeyun=厄运
zeyi=恶意
zenyuan=恩怨
zeyao=扼要
zeryu=耳语
zeyu=恶语
zeyu=阿谀
zeyun=噩运
zlvyou=旅游
zliyi=利益
zlingyu=领域
zriyi=日益
zrongyi=容易
zrongyu=荣誉
zliuyu=流域
zniuyue=纽约
zluoyang=洛阳
znuoyong=挪用
zluyin=录音
zlanyong=滥用
zliyi=礼仪
znongyu=浓郁
znaiyong=耐用
zrongye=溶液
zlunyi=轮椅
zlingyuan=陵园
zlianyi=联谊
zlvyue=履约
zliaoyang=疗养
zlianyin=联姻
zlengyin=冷饮
zliangyi=两翼
zliaoyuan=燎原
zlayue=腊月
zlvyin=绿荫
znuoyan=诺言
zrongyao=荣耀
zlongya=聋哑
zruiyi=锐意
zliyu=鲤鱼
zlaoyin=烙印
zliyuan=梨园
zlinyu=淋浴
zrongyuan=冗员
zrongying=荣膺
zrenyi=仁义
zlaoye=老爷
znuyi=奴役
zlingyang=羚羊
zliyi=离异
zzhanye=粘液
zrouyan=肉眼
zleiyu=雷雨
zrongyan=容颜
zliyu=礼遇
zliangyuan=良缘
zlianyi=涟漪
zlanyao=拦腰
zluyun=陆运
zlingyan=灵验
zlaoyi=劳役
zlieyan=烈焰
zliangyi=凉意
zliyou=利诱
zlingyang=领养
zlingyu=囹圄
zlaoyu=牢狱
zrongyan=熔岩
zliyu=俚语
zlianyu=炼狱
zreyan=惹眼
zlaoying=老鹰
zlingyong=零用
zluying=露营
znuoyi=挪移
zlveyu=略语
zliuying=流萤
znianye=黏液
zanzhao=按照
zanzhi=安置
zaizheng=癌症
zaozhou=澳洲
zanzang=安葬
zaozhan=鏖战
zangzang=肮脏
zaizeng=爱憎
zaizheng=挨整
zezhi=遏制
zezhi=遏止
zenze=恩泽
zezhan=恶战
zezha=讹诈
zlanzhou=兰州
zlongzhong=隆重
zlianzheng=廉政
zniuzhuan=扭转
zlizi=例子
zliezhi=劣质
znianzhong=年终
zlizhi=荔枝
zlvzhou=绿洲
znaozi=脑子
zlaozi=劳资
zlizhi=理智
zrizhao=日照
zlongzhao=笼罩
zniuzai=牛仔
zlaozuo=劳作
zniangzao=酿造
zlizheng=例证
zlinzhong=临终
zruozhi=弱智
zlazhu=蜡烛
zlongzhou=龙舟
zluzi=炉子
zlanzhu=拦住
zruizhi=睿智
zrezhong=热衷
zneizang=内脏
zruzhi=乳汁
znizhuan=逆转
zniezao=捏造
zlanzi=篮子
zlianzi=莲子
zluzao=炉灶
zluanzi=卵子
zrenzui=认罪
zlongzi=笼子
znaozhong=闹钟
zlangzhong=郎中
zliaozhai=聊斋
zranzhi=染指
zliuzhi=留置
zlingzi=领子
zlianzhi=炼制
zlinzhan=临战
zleizhui=累赘
zluozi=骡子
zluzhang=路障
zrunze=润泽
zlangzi=浪子
zneizhai=内债
zluzhu=露珠
zrenzheng=仁政
zlingzhu=领主
zruanzuo=软座
znizhao=泥沼
zlinzhen=临阵
zlazhi=蜡纸
zlongzi=聋子
zniezi=镊子
zlianzhui=连缀
zlanzu=拦阻
zlvzhi=滤纸
zluozhi=罗织
zruzhao=乳罩
zningzhi=凝滞
zlianzi=链子
znizuo=拟作
zlaozhen=落枕
zlunzui=论罪
zlingzun=令尊
zniezhang=孽障
zouzhou=欧洲
zbeian=备案
zbian=彼岸
zbeiai=悲哀
zboai=博爱
zboen=波恩
zbiane=匾额
zbaoen=报恩
zbili=比例
zboli=玻璃
zbali=巴黎
zboruo=薄弱
zbolan=波兰
zbaoli=暴利
zbaolu=暴露
zbaoli=暴力
zbenling=本领
zbulao=捕捞
zbinlin=濒临
zbilu=秘鲁
zbianlun=辩论
zbaoli=剥离
zbaolei=堡垒
zbingli=兵力
zbulv=步履
zbuliao=布料
zbeili=背离
zbingli=病例
zbaolan=包揽
zbilei=壁垒
zbainian=拜年
zbini=比拟
zbolan=波澜
zboluo=菠萝
zbaorong=包容
zbianren=辨认
zbolang=波浪
zburu=哺乳
zbaonuan=保暖
zbanlv=伴侣
zbilv=碧绿
zbeiru=被褥
zbalei=芭蕾
zbaoluan=暴乱
zbiliang=鼻梁
zbanlan=斑斓
zbingliang=冰凉
zbiaolu=表露
zbieniu=别扭
zbinglang=槟榔
zbaoli=薄利
zboluo=剥落
zbeilun=悖论
zbeilie=卑劣
zbeiliang=悲凉
zbeilei=蓓蕾
zbailu=败露
zbaolie=爆裂
zbeilu=北麓
zbeiliao=备料
zbailei=败类
zbailuo=败落
zbili=臂力
zbonong=拨弄
zbaonve=暴虐
zbulou=补漏
zbilan=碧蓝
zbinv=婢女
zbaonu=暴怒
zboli=薄礼
zbaoli=暴戾
zbenglie=迸裂
zbanniang=伴娘
zbanlang=伴郎
zbinlian=殡殓
zbanbu=颁布
zbaba=爸爸
zbianbu=遍布
zbenbo=奔波
zbiaobing=标兵
zbiaoben=标本
zbibei=必备
zbibing=弊病
zbaobei=宝贝
zbaobi=包庇
zbubing=步兵
zbianbie=辨别
zbaobian=褒贬
zbeibao=背包
zbaobao=宝宝
zbiaobang=标榜
zbaobiao=保镖
zbingbao=冰雹
zbaibu=摆布
zbibang=臂膀
zbeibu=背部
zbanbo=斑驳
zbianbo=辩驳
zbaibei=败北
zbanbao=板报
zbaibai=拜拜
zbeibi=卑鄙
zbobao=播报
zbaibi=败笔
zbingbang=冰棒
zbingbao=禀报
zbianbai=辩白
zbabing=把柄
zbibao=鄙薄
zpaobing=刨冰
zbuchong=补充
zbuchang=补偿
zbaochou=报酬
zbici=彼此
zbochu=播出
zbenchi=奔驰
zbingchuan=冰川
zbianchui=边陲
zbancai=板材
zbeican=悲惨
zbiance=鞭策
zbanchan=班禅
zbaochang=饱尝
zbochi=驳斥
zbanche=板车
zbocai=菠菜
zbeicha=备查
zbichu=笔触
zbiaochi=标尺
zbingcheng=秉承
zbeichuang=悲怆
zbaochou=报仇
zbaochao=包抄
zbachang=靶场
zbangcheng=磅秤
zbanchang=伴唱
zbaocan=饱餐
zbaocang=保藏
zbiancan=便餐
zbachu=拔除
zbianchi=鞭笞
zbaichi=白痴
zbaocang=包藏
zbangchui=棒槌
zbingchu=摒除
zbingchi=秉持
zbangchen=帮衬
zbachu=罢黜
zbingchu=屏除
zbodong=波动
zbiduan=弊端
zboduo=剥夺
zbaodi=宝地
zbodou=搏斗
zbiandi=遍地
zboda=博大
zbode=博得
zbaodie=暴跌
zboduan=波段
zbiandan=扁担
zbandeng=板凳
zbiandi=贬低
zbuding=补丁
zbengdai=绷带
zbiaodian=标点
zbandian=斑点
zbaidu=摆渡
zbadao=霸道
zbandong=搬动
zbideng=壁灯
zbaidu=拜读
zbaida=白搭
zbandao=绊倒
zbeidai=背带
zbaodian=宝典
zbeide=背地
zbaidao=拜倒
zbendan=笨蛋
zbodao=驳倒
zbeidao=悲悼
zbaohu=保护
zbufa=步伐
zbanfa=颁发
zbaihuo=百货
zbaofu=包袱
zbohai=渤海
zbeihou=背后
zbaofa=爆发
zbaohe=饱和
zbofang=播放
zbaofei=报废
zbihua=壁画
zbaifang=拜访
zbianhu=辩护
zbaihuai=败坏
zbiaohao=标号
zbaohan=饱含
zbohui=驳回
zbaofa=暴发
zbofu=拨付
zbengfa=迸发
zbohe=薄荷
zbaihui=拜会
zbeifu=背负
zbohao=拨号
zbufa=补发
zbihu=庇护
zbuhuo=捕获
zbofa=播发
zbaofu=暴富
zbaohua=刨花
zbahen=疤痕
zbeifen=备份
zbeifen=悲愤
zbinfen=缤纷
zbingfa=兵法
zbofu=伯父
zbaohan=包涵
zbianfu=蝙蝠
zbeihuan=悲欢
zbingfu=禀赋
zbahe=拔河
zbifeng=笔锋
zbihe=逼和
zbaofeng=暴风
zbaohan=抱憾
zbihui=避讳
zbeifen=辈分
zbianhan=便函
zbiaohu=裱糊
zbaihuo=败火
zbanghe=棒喝
zbangfu=绑缚
zbaogao=报告
zbaogui=宝贵
zbeigao=被告
zbaogang=宝钢
zbiaoguang=曝光
zbiaoge=表格
zbaoguo=包裹
zbinggong=秉公
zbinggan=饼干
zbinggui=冰柜
zbeiguan=悲观
zbagong=罢工
zbinggu=病故
zbigong=逼供
zbeige=悲歌
zbinggun=冰棍
zbagao=拔高
zbiangu=变故
zbugao=布告
zbaguan=罢官
zbiangua=变卦
zbaogu=苞谷
zbuguo=补过
zbinggao=禀告
zbeiguang=背光
zbaojian=保健
zbianji=编辑
zbuju=布局
zbeijing=背景
zbianjing=边境
zbijing=毕竟
zbianjie=边界
zbiaojia=标价
zbianjiang=边疆
zbanjiang=颁奖
zbianji=遍及
zbeiju=悲剧
zbiaoji=标记
zbanjing=半径
zbianjie=便捷
zboji=波及
zbanjia=搬家
zboji=搏击
zbujiu=补救
zbijin=逼近
zbangjia=绑架
zbeijian=备件
zbuji=补给
zbaojie=报界
zbangjiao=邦交
zbingjun=病菌
zbaojia=保驾
zbajian=拔尖
zbaojie=保洁
zbianjie=辩解
zbujing=布景
zbanjie=半截
zbanjie=板结
zbaojiang=褒奖
zbajiao=芭蕉
zbiji=笔迹
zbaiju=败局
zbaijing=白净
zbaiji=败绩
zboji=簸箕
zbaijian=拜见
zbaojie=报捷
zbaijin=拜金
zbiejiao=蹩脚
zbojue=伯爵
zbianjian=便笺
zbaijiang=败将
zbeijian=卑贱
zbinjiao=鬓角
zbojiang=播讲
zbaojun=暴君
zbaokuo=包括
zbokuan=拨款
zbaoku=宝库
zbaokao=报考
zbankuai=板块
zbengkui=崩溃
zbuke=补课
zbaikuo=摆阔
zbeike=贝壳
zbikong=鼻孔
zbiankuang=边框
zbukao=补考
zbake=罢课
zbeiku=悲苦
zbimian=避免
zbaomi=保密
zbimu=闭幕
zbaomo=薄膜
zbiaoming=标明
zbianma=编码
zbaomu=保姆
zbaoman=饱满
zbamian=罢免
zbaoman=爆满
zbeimian=背面
zbingma=兵马
zbiming=毙命
zbiemen=憋闷
zbanma=斑马
zbaimu=柏木
zbaomu=报幕
zbamai=把脉
zbomu=伯母
zbeimiu=悖谬
zboming=薄命
zbeipo=被迫
zbianpao=鞭炮
zbaopo=爆破
zbupi=布匹
zbipo=逼迫
zbupin=补品
zbeipan=背叛
zbianping=扁平
zbaipu=摆谱
zbangpiao=绑票
zbanpei=般配
zbanqian=搬迁
zbianqian=变迁
zbiaoqian=标签
zbingqi=摒弃
zbuque=补缺
zbangqiu=棒球
zbiaoqiang=标枪
zbaoqian=抱歉
zbaquan=霸权
zbinqi=摈弃
zboqu=博取
zbeiqi=背弃
zbiqi=荸荠
zbieqi=憋气
zbangqiang=帮腔
zbaqi=霸气
zbiqi=鄙弃
zbingqi=屏气
zbeiqi=悲泣
zbianqing=辨清
zboqing=薄情
zbaoqu=抱屈
zbisai=比赛
zboshi=博士
zbushu=部署
zbansui=伴随
zbieshu=别墅
zbaoshi=宝石
zbangshou=榜首
zbeishou=备受
zbashe=跋涉
zbiaoshu=表述
zbise=闭塞
zbisheng=毕生
zbishu=避暑
zbaoshou=饱受
zbeisong=北宋
zbeishang=悲伤
zbishou=匕首
zbaisu=败诉
zbaishi=拜师
zbosa=播撒
zbeisong=背诵
zbusha=捕杀
zbashi=巴士
zbiaoshi=标示
zbishi=鄙视
zbanshou=扳手
zbosong=播送
zbaishu=柏树
zbishi=笔试
zbiansai=边塞
zbanshang=半晌
zbianshi=辨识
zbiansun=贬损
zbaishu=白薯
zbaoshi=保释
zbingshu=兵书
zbashou=罢手
zbingshi=冰释
zbaishou=拜寿
zbaosang=报丧
zbutie=补贴
zbaituo=摆脱
zbingtuan=兵团
zbiaoti=标题
zbaitang=白糖
zbeitong=悲痛
zbenteng=奔腾
zbiaotai=表态
zbaitan=摆摊
zbotong=拨通
zbotao=波涛
zbingtai=病态
zbiantai=变态
zbingtang=冰糖
zbianta=鞭挞
zbaotu=暴徒
zbaitui=败退
zbiti=鼻涕
zbiting=笔挺
zbaituo=拜托
zbutai=步态
zbatui=拔腿
zbeitan=悲叹
zpingtui=屏退
zbawo=把握
zbaowei=包围
zbangwan=傍晚
zbaowen=保温
zbawang=霸王
zbingwei=病危
zbeiwei=北纬
zbeiwen=碑文
zbowen=波纹
zbeiwo=被窝
zbaowu=宝物
zbeiwei=卑微
zbaiwang=拜望
zbiwen=逼问
zbiwu=笔误
zbaoxian=保险
zbingxiang=冰箱
zbianxing=变形
zbaoxian=保鲜
zboxue=剥削
zbenxi=本息
zbaoxiao=报效
zbuxie=布鞋
zbuxi=补习
zbaxiu=罢休
zbaoxing=暴行
zbaoxi=报喜
zbaoxiao=报晓
zbaoxiang=包厢
zboxue=博学
zbuxian=布线
zbanxing=颁行
zbuxue=补血
zbaixi=白皙
zbanxiang=扮相
zbinxi=屏息
zbaixing=败兴
zbingxie=冰鞋
zbixie=碧血
zbixian=避嫌
zbeixia=卑下
zbingxing=禀性
zbixie=辟邪
zbinxiang=傧相
zbaixie=拜谢
zbiye=毕业
zbiaoyan=表演
zboyin=波音
zbangyang=榜样
zbianyuan=边缘
zbaoyu=暴雨
zbianyi=编译
zbanyan=扮演
zbaoyuan=抱怨
zbiaoyu=标语
zbiyu=比喻
zbingyi=兵役
zbeiyong=备用
zbiyun=避孕
zbanyun=搬运
zbaiyin=白银
zbuyu=哺育
zbaiyou=柏油
zboyin=播音
zbiyi=裨益
zboying=播映
zbinyu=濒于
zbaoyou=保佑
zbanyuan=半圆
zbeiying=背影
zbaoyang=褒扬
zbuyang=补养
zbiyin=鼻音
zbianyi=贬抑
zbuyao=补药
zbuyi=补益
zbiyi=鄙夷
zbaye=霸业
zbeiyun=背运
zbiyi=笔译
zbaoyi=褒义
zbiaozhun=标准
zbangzhu=帮助
zbaozhang=保障
zbiaozhi=标志
zbaozhi=报纸
zbiaozhang=表彰
zbuzhou=步骤
zbenzhi=本质
zbaozha=爆炸
zbuzhu=补助
zbuzhi=布置
zbozhong=播种
zbianzhi=编织
zbiaoshi=标识
zbianzheng=辩证
zbuzhuo=捕捉
zbianzhi=贬值
zbaozhu=爆竹
zbizi=鼻子
zbianzhi=变质
zbozi=脖子
zbaozhang=暴涨
zbingzheng=病症
zbizhen=逼真
zbinzang=殡葬
zbeizhuang=悲壮
zbeizhan=备战
zbaozuo=宝座
zbingzhong=兵种
zbanzou=伴奏
zbaizhi=白纸
zboshe=波折
zbianzhuan=编撰
zbazhu=霸主
zbaozang=宝藏
zbiaozhi=标致
zbuzu=补足
zbizhi=币值
zbaozu=包租
zbenzhong=笨重
zbaozha=包扎
zbizhi=壁纸
zbangzi=膀子
zbizu=鼻祖
zbaizhou=白昼
zbianzi=辫子
zbeizhu=备注
zbazhan=霸占
zbianzi=鞭子
zbozhong=伯仲
zbenzhuo=笨拙
zbaizhang=败仗
zbaizhen=败阵
zbazi=靶子
zbaozao=暴躁
zbaozi=豹子
zbeizhao=被罩
zbizhang=臂章
zbanzui=拌嘴
zbazhi=罢职
zchenai=尘埃
zcanan=惨案
zchongai=宠爱
zciai=慈爱
zchuiai=垂爱
zchoue=丑恶
zchonger=宠儿
zcier=刺耳
zchange=嫦娥
zceer=侧耳
zcailiao=材料
zceliang=测量
zcelve=策略
zchuliang=储量
zcanlan=灿烂
zchaoliu=潮流
zchengnuo=承诺
zchilun=齿轮
zcaina=采纳
zcuiruo=脆弱
zcharu=插入
zchuli=矗立
zcheli=撤离
zcanliu=残留
zchuanran=传染
zchenglan=承揽
zchengran=诚然
zchuangru=闯入
zcongrong=从容
zcanlian=残联
zchunli=纯利
zculve=粗略
zchiru=耻辱
zchanlian=蝉联
zchuna=出纳
zcaolao=操劳
zcaoni=草拟
zcuilv=翠绿
zchuanglian=窗帘
zconglin=丛林
zcanren=残忍
zchuilian=锤炼
zchuanlian=串联
zchanrao=缠绕
zchunlei=春雷
zchulong=出笼
zcainuan=采暖
zchaolu=抄录
zcangliang=苍凉
zcangni=藏匿
zchoulou=丑陋
zchuiniu=吹牛
zchonglang=冲浪
zciliao=磁疗
zchengliang=乘凉
zchenlun=沉沦
zcaolian=操练
zcanglao=苍老
zchulian=初恋
zchaonong=嘲弄
zchalou=茶楼
zchaonao=吵闹
zchiluo=赤裸
zcaili=彩礼
zchaoling=超龄
zchourong=愁容
zchenni=沉溺
zcanlie=惨烈
zchuiliu=垂柳
zcuran=猝然
zchilie=炽烈
zculie=粗劣
zchoulao=酬劳
zchanruo=孱弱
zchangliang=敞亮
zchanli=颤栗
zculu=粗鲁
zconglve=从略
zchailang=豺狼
zchaorang=吵嚷
zchalu=岔路
zciling=辞令
zchana=刹那
zchouren=仇人
zchengneng=逞能
zchunu=触怒
zchalu=茶炉
zcailve=才略
zchileng=齿冷
zcannian=残年
zchuanbo=传播
zchuanbo=船舶
zchubei=储备
zchoubei=筹备
zchaobiao=超标
zchibang=翅膀
zchengbai=成败
zchongbai=崇拜
zchouban=筹办
zchuanbian=传遍
zcangbai=苍白
zcubao=粗暴
zchengba=称霸
zcaoban=操办
zchoubin=酬宾
zchabei=茶杯
zcanbai=惨败
zcanbao=残暴
zcuobai=挫败
zchaobai=朝拜
zchangbei=常备
zchengban=惩办
zcanbai=参拜
zcuiban=催办
zzhongbo=重播
zcaibao=财宝
zcibei=慈悲
zchaoben=抄本
zcaibi=彩笔
zcanbai=惨白
zcibie=辞别
zcubu=粗布
zcanbu=残部
zchubin=出殡
zcubi=粗鄙
zchebing=撤兵
zcuben=粗笨
zchuangba=疮疤
zchoucuo=筹措
zchicun=尺寸
zchucun=储存
zcongcong=匆匆
zchaichu=拆除
zcunchu=存储
zcangchu=仓储
zchengche=乘车
zcucheng=促成
zchichi=迟迟
zchechu=撤出
zchengchu=惩处
zcucao=粗糙
zchuncui=纯粹
zchongchi=充斥
zcuican=璀璨
zchengcai=成材
zcuican=摧残
zchicheng=赤诚
zchicheng=驰骋
zchuchen=除尘
zchucang=储藏
zcaochang=操场
zchuchuang=橱窗
zcaice=猜测
zchanchu=铲除
zchengchuan=乘船
zchuancai=川菜
zcuicu=催促
zcancun=残存
zcangcu=仓促
zchuancha=穿插
zchuancang=船舱
zchanchan=潺潺
zcaocong=草丛
zchouchang=惆怅
zcaiche=彩车
zcangcui=苍翠
zcaochi=操持
zchechu=撤除
zchouchu=踌躇
zcuoci=措词
zcanche=餐车
zcicheng=辞呈
zchouchu=抽搐
zcuoci=措辞
zchanchu=蟾蜍
zchuaice=揣测
zcongcong=淙淙
zchachao=查抄
zchucao=出操
zchuochuan=戳穿
zchencu=陈醋
zchouchong=臭虫
zchengchi=撑持
zchuchou=出丑
zcongcu=匆促
zchaichuan=拆穿
zcuichan=催产
zchengche=澄澈
zchicu=吃醋
zchengdu=程度
zchengdan=承担
zchedi=彻底
zcaidian=彩电
zchangdao=倡导
zchuandi=传递
zceding=测定
zcidian=词典
zcidian=辞典
zchendian=沉淀
zcaiding=裁定
zchidu=尺度
zchudong=触动
zchengdui=承兑
zzhongdie=重叠
zchidao=迟到
zchundu=纯度
zchandou=颤抖
zchadui=插队
zchuidiao=垂钓
zchidai=痴呆
zcaideng=彩灯
zchuangdang=闯荡
zchidun=迟钝
zchengdui=成堆
zcandou=蚕豆
zchouduan=绸缎
zchudian=触电
zchandong=颤动
zcaidai=彩带
zchengdi=呈递
zcengdie=层叠
zchangda=畅达
zcandan=惨淡
zcedong=策动
zcuodao=锉刀
zchuidong=吹动
zchuaiduo=揣度
zchoudi=仇敌
zcaidu=猜度
zcuanduo=篡夺
zchadao=岔道
zchouda=酬答
zchedan=扯淡
zcaiduo=裁夺
zcundu=忖度
zchuanghui=创汇
zcehui=测绘
zchifan=吃饭
zcehua=策划
zchufang=厨房
zzhongfan=重返
zchengfa=惩罚
zchouhua=筹划
zcaihong=彩虹
zchuhu=储户
zcaifa=采伐
zcunhuo=存货
zchufan=触犯
zcuihui=摧毁
zchuanghu=窗户
zchihuan=迟缓
zcihui=词汇
zchehuo=车祸
zchehui=撤回
zcaifa=财阀
zchufa=触发
zcanfei=残废
zchongfeng=冲锋
zchenfu=沉浮
zchanfu=搀扶
zchehuan=撤换
zcanhai=残害
zcaifeng=裁缝
zchuifu=吹拂
zcihai=辞海
zcaihui=彩绘
zcanghai=沧海
zchahua=茶花
zchuanhuan=传唤
zconghui=聪慧
zcouhe=凑合
zchouhen=仇恨
zcanhai=残骸
zchahua=插花
zzhongfeng=重逢
zchuohao=绰号
zchanhui=忏悔
zcuohe=撮合
zcihou=伺候
zchaofeng=嘲讽
zchahu=茶壶
zchengfa=乘法
zchunhui=春晖
zchanfa=阐发
zchenfu=陈腐
zcanghuang=仓皇
zchunhou=醇厚
zchuifeng=吹风
zchaihui=拆毁
zchunhou=淳厚
zcanfei=餐费
zchouhua=丑化
zcifu=慈父
zchufan=初犯
zcefan=策反
zcanhuo=惨祸
zchaifeng=拆封
zcongfan=从犯
zchafang=察访
zchenhun=晨昏
zchuanghuo=闯祸
zchengfang=乘方
zchonghuai=宠坏
zchenhuo=陈货
zchanhuo=搀和
zchefang=撤防
zchangfu=娼妇
zcifeng=词锋
zchonggao=崇高
zchanggui=常规
zcanguan=餐馆
zchaguan=茶馆
zcuguang=粗犷
zchugao=初稿
zcaogao=草稿
zcuangai=篡改
zchengui=陈规
zchuge=出格
zchenggan=秤杆
zchenguai=嗔怪
zchegu=彻骨
zcuangai=窜改
zcujin=促进
zchengji=成绩
zcanji=残疾
zchashu=差距
zchouji=筹集
zciji=刺激
zchoujian=筹建
zcaijue=裁决
zchujing=出境
zchenji=沉积
zchangjue=猖獗
zchaijie=拆借
zchujing=处境
zchengjiao=城郊
zchejun=撤军
zchunjie=纯洁
zchuji=触及
zchengji=乘机
zchenjin=沉浸
zcaijian=裁减
zcanju=餐具
zchongjing=崇敬
zcaijue=采掘
zchongjing=憧憬
zchenji=趁机
zchunjing=纯净
zcaijun=裁军
zchongji=充饥
zchuiju=炊具
zcaijian=裁剪
zchajue=察觉
zchoujin=酬金
zcongjian=从简
zchaju=茶具
zcanju=惨剧
zchaji=茶几
zcangjing=苍劲
zchenjing=沉静
zchujue=触觉
zchuangjin=闯劲
zchengjie=惩戒
zcanjin=餐巾
zchujiao=触礁
zchaji=查缉
zcanjiao=惨叫
zcanju=残局
zchangji=娼妓
zchoujin=抽筋
zchaijian=拆建
zchoujie=筹借
zchenji=陈迹
zchoujue=丑角
zchuoji=戳记
zchujie=出界
zchajiu=查究
zcoujin=凑近
zchanjuan=婵娟
zchouju=丑剧
zcijiao=赐教
zchaojian=抄件
zcaiji=猜忌
zchanji=禅机
zchanjie=缠结
zchuangkou=窗口
zcankao=参考
zcangku=仓库
zchengke=乘客
zchengkong=程控
zchangkai=敞开
zchakan=察看
zchikui=吃亏
zchiku=吃苦
zcanku=残酷
zcike=此刻
zchengken=诚恳
zchoukuan=筹款
zcankui=惭愧
zchangkuang=猖狂
zchaikai=拆开
zchongkua=冲垮
zcongkan=丛刊
zchangku=长裤
zcuikuan=催款
zchangkuai=畅快
zchouku=愁苦
zchakao=查考
zchakou=插口
zchangkou=敞口
zcongming=聪明
zcemian=侧面
zchiming=驰名
zcanmou=参谋
zchanming=阐明
zchenmo=沉默
zcaomei=草莓
zchoumi=稠密
zchumo=触摸
zcongmang=匆忙
zcaomao=草帽
zchenmen=沉闷
zchimi=痴迷
zcangmang=苍茫
zchouma=筹码
zchangmian=长眠
zchunmao=纯毛
zchuanmen=串门
zchengmu=瞠目
zchuaimo=揣摩
zcimu=慈母
zchanmian=缠绵
zcaomi=糙米
zcaimi=猜谜
zchenmian=沉湎
zchengmeng=承蒙
zcuimian=催眠
zcemu=侧目
zchima=尺码
zchunmei=纯美
zcaomang=草莽
zchuimu=垂暮
zchouma=臭骂
zcaimao=才貌
zchoumen=愁闷
zchimu=迟暮
zchanmei=谄媚
zcemen=侧门
zchima=斥骂
zchoumei=臭美
zchanpin=产品
zchengpin=成品
zcaipan=裁判
zchaopiao=钞票
zcaipiao=彩票
zchongpei=充沛
zcaoping=草坪
zchepi=扯皮
zchunpu=纯朴
zcipin=次品
zchunpu=淳朴
zchupin=出品
zcaipu=菜谱
zceping=测评
zchuangpu=床铺
zchuipeng=吹捧
zchangpao=长袍
zcaopeng=草棚
zcanpo=残破
zcaipai=彩排
zchipin=赤贫
zcipin=词频
zchapu=查铺
zchepeng=车棚
zchengpu=诚朴
zchaiqian=拆迁
zdengqing=澄清
zciqu=辞去
zciqi=瓷器
zcanque=残缺
zchengqiang=城墙
zchangqiang=唱腔
zcaiqi=彩旗
zchouqian=抽签
zcaoqian=草签
zchaqu=插曲
zchuiqing=垂青
zchouqi=臭气
zchiqing=痴情
zcouqiao=凑巧
zchuqin=出勤
zcangqiong=苍穹
zcuqian=粗浅
zchuanqi=喘气
zchunqing=纯情
zchouqi=抽泣
zchengqiang=逞强
zchaoqi=潮气
zchaiqian=差遣
zchuoqi=啜泣
zcuanquan=篡权
zcuoshi=措施
zchengshu=成熟
zcushi=促使
zceshi=测试
zcaise=彩色
zchangshi=尝试
zchuanshu=传输
zcansai=参赛
zcesuo=厕所
zchanshu=阐述
zcesuan=测算
zzhongshen=重申
zchenshan=衬衫
zcuoshang=磋商
zcongshu=丛书
zchangshou=长寿
zchuanshou=传授
zcangshu=藏书
zchengshi=诚实
zchangshi=常识
zcangsang=沧桑
zcishan=慈善
zchushi=厨师
zchongshang=崇尚
zchuansuo=穿梭
zchenshu=陈述
zcuoshang=挫伤
zchaoshi=潮湿
zchunshu=纯属
zchesu=车速
zcishu=辞书
zcongsheng=丛生
zchaoshui=潮水
zchashou=插手
zchashui=茶水
zchongshua=冲刷
zcanshi=蚕食
zchangsheng=昌盛
zcuisheng=催生
zchaosu=超速
zcongsu=从速
zchengsong=称颂
zcansi=惨死
zchuansong=传诵
zchushi=初试
zceshen=侧身
zchaosong=抄送
zcusu=粗俗
zcaoshou=操守
zcangsong=苍松
zchesu=撤诉
zchunshi=蠢事
zcangshen=藏身
zcashi=擦拭
zcansun=残损
zcaishu=菜蔬
zchusai=初赛
zchenshi=趁势
zcaosheng=草绳
zchunshu=纯熟
zchangshan=长衫
zchongsai=充塞
zchaisan=拆散
zchousha=仇杀
zchoushi=仇视
zcunshe=村舍
zchenshi=尘世
zchisu=吃素
zchunsun=春笋
zchuisi=垂死
zchunshe=唇舌
zchusheng=畜生
zchanshi=禅师
zcaishi=才识
zcoushu=凑数
zcansheng=残生
zchongtu=冲突
zcanting=餐厅
zchangtu=长途
zchangtong=畅通
zcitui=辞退
zchangtan=畅谈
zchetui=撤退
zchitang=池塘
zchentu=尘土
zchuantou=穿透
zchatu=插图
zcantong=惨痛
zchouti=抽屉
zchentuo=衬托
zchuting=出庭
zchuantong=串通
zchatou=插头
zchutou=锄头
zchaotuo=超脱
zcangtian=苍天
zchitou=吃透
zcitang=祠堂
zchuangtai=窗台
zchangtai=常态
zcitan=刺探
zchaitai=拆台
zcuotuo=蹉跎
zchetai=车胎
zcaita=踩踏
zchoutai=丑态
zchengtuo=秤砣
zcuitao=催讨
zcuowu=错误
zchongwu=宠物
zchengwei=称谓
zzhongwen=重温
zchouwen=丑闻
zchuiwei=垂危
zchenwen=沉稳
zchangwen=常温
zchangwei=肠胃
zcunwang=存亡
zzhongwei=重围
zchawan=茶碗
zchangwang=怅惘
zciwei=刺猬
zchiwu=迟误
zcuanwei=篡位
zchengxu=程序
zchixu=持续
zchuxi=出席
zchaoxian=朝鲜
zchengxiao=成效
zchuxu=储蓄
zchangxiao=畅销
zcuxiao=促销
zchexiao=撤销
zchexiang=车厢
zchuoxue=辍学
zchuxing=雏形
zchunxia=春夏
zchuxi=除夕
zchongxi=冲洗
zcixiu=刺绣
zchexiao=撤消
zchengxiong=称雄
zcixu=次序
zcixiang=慈祥
zcaoxin=操心
zchaoxi=潮汐
zchuxia=初夏
zcaixiang=猜想
zchaixie=拆卸
zchuxi=出息
zcaxi=擦洗
zchengxin=诚心
zchaoxi=抄袭
zchenxi=晨曦
zcaoxie=草鞋
zchuanxi=喘息
zcuxi=促膝
zchaoxiao=嘲笑
zchixin=痴心
zchaoxie=抄写
zchuixu=吹嘘
zcaoxi=草席
zchunxiang=醇香
zcaixie=采撷
zcaixia=彩霞
zcixiong=雌雄
zchengxiang=丞相
zchouxie=酬谢
zchengxi=承袭
zcaoxing=操行
zchangxiang=畅想
zchangxu=畅叙
zcixing=雌性
zchengxiong=逞凶
zcanxue=残雪
zchengxing=乘兴
zcixing=辞行
zchaixi=拆洗
zchengxi=乘隙
zchengxian=呈献
zchaxiao=插销
zchuanxian=船舷
zchouxu=愁绪
zchaoxue=巢穴
zchongxing=宠幸
zcixie=辞谢
zchengxu=称许
zchongxin=宠信
zchouxi=仇隙
zcuxia=促狭
zchayi=差异
zchaiyou=柴油
zchaye=茶叶
zcanyin=餐饮
zchayue=查阅
zchangyi=倡议
zchengyi=诚意
zchongyu=充裕
zcaiyao=菜肴
zchayan=查验
zchenyi=衬衣
zcaiyin=彩印
zcaiyuan=裁员
zcanyu=残余
zzhongyan=重演
zceyan=测验
zcuyong=簇拥
zcangying=苍蝇
zcheye=彻夜
zchayang=插秧
zchiyi=迟疑
zcanyue=参阅
zcongying=聪颖
zchaoye=朝野
zchouyang=臭氧
zchayi=诧异
zchengyao=撑腰
zciyu=赐予
zchengyu=称誉
zchuiyan=炊烟
zcaiyi=猜疑
zcaiyun=彩云
zchangyou=畅游
zchuanyue=传阅
zchunyou=春游
zchongyi=充溢
zchongying=充盈
zcanyi=参议
zcongyu=葱郁
zchuyou=出游
zchenyin=沉吟
zceying=策应
zchuyi=刍议
zchouyun=愁云
zcuye=粗野
zchangyin=畅饮
zchaye=插页
zceyi=侧翼
zchiyan=迟延
zchanyin=颤音
zcanyue=残月
zcanyang=残阳
zcaiyi=才艺
zcaoyan=操演
zchenyuan=沉冤
zchouyuan=仇怨
zceyin=恻隐
zchanyan=谗言
zchouye=抽噎
zchengyue=呈阅
zchanyou=颤悠
zcaozuo=操作
zchuzu=出租
zchengzan=称赞
zchouzi=筹资
zcanzhao=参照
zcunzhuang=村庄
zcaozong=操纵
zcizhi=辞职
zchuizhi=垂直
zchengzuo=乘坐
zchuzhi=处置
zchengzhi=惩治
zcezhong=侧重
zchengzu=承租
zzhongzhen=重振
zcuozhe=挫折
zcanzhuo=餐桌
zchuzhong=初衷
zchanza=掺杂
zchengzhi=诚挚
zcanzhong=惨重
zcaizhi=材质
zchunzheng=纯正
zchizao=迟早
zchezou=撤走
zcizhuan=瓷砖
zcaizhi=才智
zcaizhai=采摘
zchezhi=撤职
zchuzhong=出众
zcanzao=惨遭
zchazuo=茶座
zchunzhen=纯真
zchazuo=插座
zcaizhao=彩照
zcanzan=参赞
zchongzhuang=冲撞
zcaoza=嘈杂
zcuizhu=翠竹
zchizi=尺子
zcuzhuang=粗壮
zchongzi=虫子
zchuizi=锤子
zchenzui=沉醉
zcanzhuang=惨状
zchize=斥责
zchenzha=沉渣
zchenzhe=趁着
zchezhou=掣肘
zchuangzi=窗子
zchuzhen=出诊
zchangzi=肠子
zchazu=插足
zchuangzhao=床罩
zchizhi=迟滞
zcouzu=凑足
zchunzhong=纯种
zzhongzou=重奏
zcaozhi=草纸
zchenzao=趁早
zchezhe=车辙
zcaizhong=猜中
zchazui=插嘴
zchuzi=厨子
zchuzhen=初诊
zcizao=辞藻
zchizhao=池沼
zcangzhuo=藏拙
zcizhui=词缀
zchanzui=馋嘴
zdiai=低矮
zdiaoer=钓饵
zdiannao=电脑
zdanren=担任
zdailing=带领
zduanlian=锻炼
zdianlan=电缆
zdianlu=电炉
zdianli=典礼
zdilian=低廉
zduanlie=断裂
zdenglu=登陆
zdianran=点燃
zdilun=涤纶
zdilie=低劣
zdalao=打捞
zdaonian=悼念
zdanlve=胆略
zduanni=端倪
zdinglv=定律
zdouliu=逗留
zdieluo=跌落
zduoluo=堕落
zdouran=陡然
zdiaonan=刁难
zdilei=地雷
zdianliang=掂量
zdongliang=栋梁
zdailao=代劳
zdarao=打扰
zdelao=地牢
zdanlei=蛋类
zdongrong=动容
zdingning=叮咛
zdenglong=灯笼
zdenglin=登临
zdiannian=惦念
zdingli=鼎立
zdaoluan=捣乱
zdianniu=电钮
zdulan=独揽
zdiaoling=凋零
zduilei=对垒
zdoule=逗乐
zdala=耷拉
zdili=砥砺
zdulun=渡轮
zdilai=抵赖
zdanao=打闹
zduoru=堕入
zdangling=党龄
zdianliao=电疗
zdouli=斗笠
zdianling=电铃
zdalei=打雷
zdula=毒辣
zdaonian=叨念
zdelou=地漏
zdanglu=挡路
zduliang=肚量
zdaolao=叨唠
zdoulan=兜揽
zdela=地蜡
zdongnei=冻馁
zdianru=玷辱
zdouou=斗殴
zduiou=对偶
zdanbao=担保
zdabiao=达标
zdaoban=盗版
zdubo=赌博
zdaibu=逮捕
zdiaobo=调拨
zdiban=地板
zdanbo=淡薄
zdabian=答辩
zdaban=打扮
zduanbo=短波
zdangbing=当兵
zdianbo=电波
zdianbo=颠簸
zdabai=打败
zdiba=堤坝
zduobi=躲避
zdanbo=单薄
zdaibing=带兵
zdianbo=点播
zduobiao=夺标
zduban=督办
zduba=独霸
zdiaobao=碉堡
zdouban=豆瓣
zdangban=挡板
zdaba=打靶
zdiebao=谍报
zdaobi=倒毙
zdianban=垫板
zdianbei=垫背
zduben=赌本
zduice=对策
zdachao=大潮
zdanchun=单纯
zducu=督促
zdanchen=诞辰
zduocai=多彩
zduncu=敦促
zdiaoche=吊车
zdaocao=稻草
zdichao=低潮
zdongcha=洞察
zdichu=抵触
zdecheng=得逞
zduchuan=渡船
zdacheng=搭乘
zduchang=赌场
zducai=独裁
zduancheng=短程
zdancheng=单程
zduancu=短促
zdaoci=悼词
zdichui=低垂
zducha=督察
zdazhan=打颤
zduocang=躲藏
zdichang=抵偿
zduanchui=断炊
zduanchang=断肠
zdechong=得宠
zdichuan=嫡传
zdaocai=倒彩
zdongchuang=冻疮
zdacha=打岔
zdunci=遁词
zdianding=奠定
zdida=抵达
zdaodan=导弹
zdidi=弟弟
zdongdang=动荡
zdiandang=典当
zdandang=担当
zdudao=督导
zdundian=蹲点
zdiandu=电镀
zdiandao=颠倒
zdingduan=顶端
zdiandi=点滴
zdadang=搭档
zdidang=抵挡
zdingdang=叮当
zdiedang=跌宕
zdiedao=跌倒
zdoudong=抖动
zdangdi=荡涤
zdiaodeng=吊灯
zdiandi=垫底
zdadu=打赌
zdaodan=捣蛋
zdiedie=爹爹
zdida=滴答
zdaodao=叨叨
zduding=笃定
zdaidu=歹毒
zdandai=担待
zdinghuo=订货
zdanfu=担负
zduihuan=兑换
zdoufu=豆腐
zdianfen=淀粉
zduifu=对付
zdaohang=导航
zduifu=兑付
zdianfan=典范
zdenghou=等候
zduifang=堆放
zdaohuo=到货
zdufu=杜甫
zdianfu=垫付
zdingfeng=顶峰
zdaohui=捣毁
zdianfu=颠覆
zdihao=低耗
zdiaohua=雕花
zdianhui=电汇
zdianfeng=巅峰
zdunhou=敦厚
zdiaohuan=吊环
zdihui=诋毁
zdanhuang=蛋黄
zdahua=打滑
zdafan=打翻
zdaifang=贷方
zdingfei=鼎沸
zdongxia=恫吓
zdianhe=电贺
zdoufeng=兜风
zdahuo=搭伙
zdianhan=电函
zdaohe=道贺
zdaofei=盗匪
zdouhao=逗号
zduhou=笃厚
zdiaohua=刁滑
zduguo=渡过
zdangao=蛋糕
zduoguan=夺冠
zdaogu=稻谷
zdonggua=冬瓜
zdigao=底稿
zdingge=定格
zdigu=嘀咕
zdinggao=定稿
zdangang=单杠
zdagu=打鼓
zduogua=多寡
zdiangu=典故
zdange=耽搁
zdiangao=电告
zdaigong=怠工
zdigui=递归
zdagun=打滚
zdaogao=祷告
zdaigou=代沟
zdaogui=捣鬼
zdiaogan=钓竿
zdaoge=倒戈
zdiguan=滴管
zdujue=杜绝
zdianji=奠基
zdongjie=冻结
zdijiao=递交
zduiji=堆积
zdijie=缔结
zdijian=递减
zdongjing=动静
zdujiang=渡江
zdianji=典籍
zdangji=党籍
zdujuan=杜鹃
zdianji=惦记
zdujin=镀金
zdiejia=叠加
zdoujiang=豆浆
zdujie=堵截
zdijie=地界
zdanjia=担架
zdijin=递进
zdiejia=跌价
zdijiao=地窖
zdiaoju=钓具
zduojiao=跺脚
zdongjiang=冻僵
zdajie=打劫
zdanjiao=旦角
zduijiang=兑奖
zdajiu=搭救
zdouji=斗鸡
zdangjia=挡驾
zduji=妒忌
zdajiao=打搅
zdijian=低贱
zdianjun=殿军
zdijie=递解
zduju=赌局
zdunji=遁迹
zdianjiu=碘酒
zdijia=递加
zdijiao=缔交
zdaikuan=贷款
zduikang=对抗
zdangke=党课
zdikang=抵抗
zdiaoke=雕刻
zdukou=渡口
zduokui=夺魁
zduokui=多亏
zduanku=短裤
zdanke=蛋壳
zduokai=躲开
zdakua=打垮
zdiankuang=癫狂
zdanke=弹壳
zdanmai=丹麦
zdaima=代码
zdongmai=动脉
zdimao=地貌
zdaomei=倒霉
zdanmo=淡漠
zdimei=弟妹
zdaiman=怠慢
zdaomu=盗墓
zdaomai=盗卖
zdongmian=冬眠
zdiema=爹妈
zdengmi=灯谜
zdiming=抵命
zdoumiao=豆苗
zdupin=毒品
zdianpu=店铺
zdapei=搭配
zdengpao=灯泡
zdoupo=陡坡
zdaipei=代培
zdangpu=当铺
zdupi=肚皮
zdipin=低频
zdiaopi=貂皮
zdepi=地痞
zdingpeng=顶棚
zdunpai=盾牌
zdengpan=登攀
zdoupeng=斗篷
zdique=的确
zdaoqie=盗窃
zdaoqian=道歉
zdiqiao=地壳
zdieqi=迭起
zdangqi=党旗
zdanqing=丹青
zdiu1qi=丢弃
zdianquan=垫圈
zdouqiao=陡峭
zdaqu=打趣
zdanqie=胆怯
zdiaoqian=调遣
zdiaoqiao=吊桥
zduiqi=堆砌
zduqi=赌气
zduqi=肚脐
zduqian=赌钱
zdaoqu=盗取
zdunqing=敦请
zdanqing=蛋清
zdianshi=电视
zdansheng=诞生
zdasai=大赛
zdiaosu=雕塑
zdongshi=董事
zdusai=堵塞
zdasuan=大蒜
zdeshi=的士
zdanshi=胆识
zdianshan=电扇
zdisu=低速
zdingsheng=鼎盛
zdoushou=兜售
zdusu=毒素
zdasui=打碎
zdashe=大赦
zdishi=敌视
zdiaoshan=吊扇
zdongsi=冻死
zdaoshi=道士
zduosuo=哆嗦
zdushe=毒蛇
zduoshan=躲闪
zdoushi=斗士
zdongshang=冻伤
zduoshou=舵手
zdousou=抖擞
zdisong=递送
zdunshi=敦实
zdashan=搭讪
zdishao=低烧
zdisheng=递升
zdaishu=袋鼠
zdingshao=盯梢
zdaosui=捣碎
zdushi=笃实
zdongtai=动态
zdaitu=歹徒
zdianti=电梯
zditan=地毯
zdaotian=稻田
zdaota=倒塌
zdiantang=殿堂
zditan=地摊
zdantian=丹田
zdongdan=动弹
zduantu=短途
zdiantong=电筒
zdutu=赌徒
zdaoteng=倒腾
zduotai=堕胎
zdatan=打探
zdaotie=倒贴
zdongti=胴体
zditing=谛听
zdatai=打胎
zduiwu=队伍
zdiwen=低温
zdanwu=耽误
zdiwa=低洼
zdianwu=玷污
zdengwen=等温
zdunwu=顿悟
zdongwu=动武
zduanwu=端午
zdiaowan=刁顽
zdianxing=典型
zdanxin=担心
zduixian=兑现
zdixing=地形
zdiaoxiao=吊销
zdingxing=定型
zduixia=对虾
zdaixie=代谢
zdixiao=抵消
zdianxian=癫痫
zdengxiao=等效
zdiaoxiang=雕像
zdaxiao=打消
zduoxing=惰性
zdaixu=待续
zdongxue=洞穴
zdixiong=弟兄
zdexi=得悉
zduanxiang=端详
zdanxin=丹心
zdingxiang=丁香
zdaxie=答谢
zdaoxie=道谢
zduxin=笃信
zdongxi=洞悉
zdiaoxie=凋谢
zduoxie=多谢
zdixi=弟媳
zdengxian=等闲
zdixin=低薪
zdiexie=喋血
zdouxiao=逗笑
zdixi=嫡系
zdingxie=钉鞋
zdaixu=代序
zdaoxi=道喜
zdanxi=旦夕
zdunxing=遁形
zdiya=抵押
zdiyu=地域
zdiaoyan=调研
zdaoyan=导演
zdongyao=动摇
zdeyu=德育
zdeyi=得益
zdanyou=担忧
zdingyue=订阅
zdiyue=缔约
zdaoyou=导游
zduoyu=多余
zdianya=典雅
zdaoyu=岛屿
zdiyu=抵御
zdiaoyu=钓鱼
zdanyao=弹药
zdangyang=荡漾
zdaoyong=盗用
zduanya=锻压
zdiaoyan=吊唁
zdaoye=倒爷
zdieyong=蝶泳
zdiyu=地狱
zdiyin=低音
zdongyi=动议
zdongying=东瀛
zduyin=读音
zduiyi=对弈
zdongyong=冬泳
zdayi=答疑
zdaoying=倒映
zdayang=打烊
zduoyi=多疑
zdangyu=党羽
zduanyang=端阳
zduyi=妒意
zdizhi=地质
zdizhen=地震
zdizhi=地址
zdizeng=递增
zdizhi=抵制
zduizhao=对照
zdanzi=担子
zdianzu=电阻
zduzi=肚子
zduanzan=短暂
zduanzheng=端正
zdizi=弟子
zdaizi=袋子
zduizhun=对准
zduzhu=堵住
zdianzhui=点缀
zdangzhang=党章
zdezui=得罪
zdingzhu=叮嘱
zdazhang=打仗
zdongzhe=动辄
zduizhi=对质
zduanzhuang=端庄
zduizhi=对峙
zdaizhi=呆滞
zdaizhuang=袋装
zdangzhong=当众
zduanzao=锻造
zduzhi=渎职
zdizao=缔造
zdengzi=凳子
zduzhuan=杜撰
zdiaozhuo=雕琢
zduzou=独奏
zdingzui=定罪
zduzhu=赌注
zdizhai=抵债
zduizheng=对症
zdaozei=盗贼
zdouzi=豆子
zdianzhang=典章
zdaozi=稻子
zdouzhi=斗智
zdianzi=垫子
zduanzhi=断肢
zdizi=笛子
zduizhan=堆栈
zdingzhuang=顶撞
zdianzuan=电钻
zdingzu=鼎足
zdengzhao=灯罩
zdiaozuan=刁钻
zdunzi=墩子
zdiezi=碟子
zduanzi=缎子
zduzhou=赌咒
zdizui=抵罪
zdaozu=刀俎
zdingzui=顶罪
zduzhi=笃志
zdizhang=抵账
zfangai=妨碍
zhouai=厚爱
zfuan=伏案
zheai=和蔼
zhunan=昏暗
zfanan=翻案
zhaoan=毫安
zhuian=晦暗
zfanan=犯案
zfuai=抚爱
zhair=孩儿
zfalv=法律
zfanrong=繁荣
zhunan=湖南
zfuli=福利
zhunluan=混乱
zhuilv=汇率
zhelan=荷兰
zhengliang=衡量
zhuilu=贿赂
zfalang=法郎
zfenlie=分裂
zfenli=奋力
zfenlan=芬兰
zhuanle=欢乐
zfanlan=泛滥
zhuli=护理
zhulve=忽略
zfouren=否认
zhonglao=洪涝
zfulao=父老
zfenglang=风浪
zhunli=婚礼
zhuilong=回笼
zfannao=烦恼
zfanren=犯人
zhulu=葫芦
zfulu=俘虏
zhualang=画廊
zfennu=愤怒
zfeiran=斐然
zhuangliang=荒凉
zhuanrao=环绕
zfeiliao=废料
zfali=乏力
zheran=赫然
zhuolun=货轮
zfanli=范例
zfurao=富饶
zhuali=华丽
zhuaniao=花鸟
zhongliu=洪流
zfanglve=方略
zfengren=缝纫
zhailang=海浪
zfulan=腐烂
zfurong=芙蓉
zhuli=狐狸
zhualiao=化疗
zhailuo=海螺
zfulu=附录
zhuolu=火炉
zhaoran=浩然
zhulin=护林
zhuaran=哗然
zhunru=混入
zfeirou=肥肉
zhouniao=候鸟
zfaliang=发亮
zhouli=厚礼
zhongrun=红润
zfengli=锋利
zfenran=愤然
zhonglong=轰隆
zhoulong=喉咙
zfanlu=翻录
zhuoluan=霍乱
zhuilei=挥泪
zhuirong=毁容
zfangliao=放疗
zfunv=父女
zhunran=浑然
zfeiniao=飞鸟
zfannan=犯难
zhanlin=翰林
zhuanong=化脓
zhongran=轰然
zhuangluan=慌乱
zhongliang=洪亮
zhuoran=豁然
zfengrao=丰饶
zhunong=糊弄
zfenglei=风雷
zhuannan=患难
zfanli=樊篱
zfanlian=翻脸
zfeili=非礼
zhunling=魂灵
zhanran=悍然
zfenluan=纷乱
zhuala=哗啦
zfanliang=饭量
zfenrao=纷扰
zheli=贺礼
zhelong=合拢
zhuangran=恍然
zfanren=烦人
zhuilu=回炉
zhainiao=海鸟
zfangling=芳龄
zhualun=滑轮
zfuli=浮力
zhaoli=毫厘
zfanli=凡例
zhulu=呼噜
zfeiren=废人
zfuru=妇孺
zhunao=胡闹
zhuangli=皇历
zhuoliang=豁亮
zhuangnian=荒年
zhuani=滑腻
zhairan=骇然
zfanrao=烦扰
zhuilong=汇拢
zfunong=抚弄
zhainiao=害鸟
zhuirao=回绕
zhuannao=欢闹
zfanglin=芳邻
zhaiou=海鸥
zhuobi=货币
zfenbu=分布
zfabu=发布
zfubai=腐败
zhubei=湖北
zhuibao=汇报
zhuoban=伙伴
zhubu=互补
zhaiba=海拔
zhoubei=后备
zfengbo=风波
zhangban=航班
zhaibin=海滨
zhuabo=划拨
zhuanbing=患病
zhuobao=火爆
zfengbao=风暴
zfengbei=丰碑
zfenbian=分辨
zhangbiao=航标
zfabao=法宝
zhuibian=汇编
zfenbian=粪便
zfubu=腹部
zfeibang=诽谤
zheiban=黑板
zfenbei=分贝
zfubei=父辈
zhaibo=海波
zfubiao=附表
zfanbu=帆布
zhuaban=花瓣
zfanbo=反驳
zfanbu=反哺
zfanban=翻版
zhebao=荷包
zhuabing=滑冰
zfeibu=肺部
zhoubo=厚薄
zfubi=复辟
zhuangbao=谎报
zfangbei=防备
zhoubu=候补
zfengbu=缝补
zhoubei=后辈
zfeibing=肺病
zhongban=红斑
zhaibao=海豹
zfenbian=分辩
zfubi=伏笔
zfubiao=浮标
zhongbei=烘焙
zhuabu=画布
zfanbing=犯病
zhuanbu=缓步
zhanbao=含苞
zhuobao=活宝
zhuabian=哗变
zfeibiao=飞镖
zhuaban=画板
zfubing=伏兵
zhaobing=号兵
zhengbao=横暴
zfeibang=匪帮
zhuibang=毁谤
zfuchi=扶持
zfuchu=付出
zfangcheng=方程
zfanchou=范畴
zhuoche=货车
zhuicui=荟萃
zhuochai=火柴
zfancai=饭菜
zfeichu=废除
zfencheng=纷呈
zfachou=发愁
zhuanchong=缓冲
zfengci=讽刺
zhaichong=害虫
zhuochang=货场
zhuichen=灰尘
zhuochuan=货船
zhechang=何尝
zfengchao=风潮
zhongcha=红茶
zhangcheng=航程
zfeicui=翡翠
zhecai=喝彩
zhouche=候车
zhengchuan=横穿
zfanchuan=帆船
zhuancheng=换乘
zfanchou=犯愁
zfeichi=飞驰
zfengchen=风尘
zhaichao=海潮
zfanche=翻车
zfencun=分寸
zfangchen=防尘
zfangchao=防潮
zheci=贺词
zfuchong=俯冲
zfanchuan=翻船
zhuichao=回潮
zfancheng=返程
zhechuan=河川
zfangcun=方寸
zhongchen=红尘
zhuangcao=荒草
zhouchen=后尘
zfuchou=复仇
zhuangchong=蝗虫
zhanchao=寒潮
zhuacong=花丛
zhuicheng=回程
zhanchuang=寒窗
zfachu=发怵
zhuanchang=欢畅
zhanchen=寒碜
zhuocang=货舱
zhuichong=蛔虫
zfuchen=浮沉
zhuangchao=皇朝
zhanchang=酣畅
zhengcai=横财
zhecao=河槽
zhuican=会餐
zhechi=呵斥
zfengchao=蜂巢
zfanchen=反衬
zfuchen=浮尘
zfengcheng=奉承
zfanchuan=反串
zhunchen=昏沉
zhuncai=荤菜
zfanchu=反刍
zfeichu=废黜
zfancheng=泛称
zhanchan=寒蝉
zhuchou=狐臭
zhongchuan=哄传
zhuche=胡扯
zhengchi=哼哧
zfudan=负担
zfandian=饭店
zfendou=奋斗
zfouding=否定
zhongdong=轰动
zhuangdi=皇帝
zhangdao=航道
zfudao=辅导
zfudi=腹地
zhuangdi=荒地
zhandan=邯郸
zhongda=宏大
zhoudu=厚度
zfudong=浮动
zfanduo=繁多
zfandu=贩毒
zhoudun=后盾
zfudan=复旦
zhudie=蝴蝶
zfangdao=防盗
zfendan=分担
zhedian=贺电
zhada=哈达
zhaoda=浩大
zhangdao=巷道
zhuidang=回荡
zhandi=旱地
zhuangdou=黄豆
zhundun=混沌
zhongdou=红豆
zfudiao=浮雕
zhaodian=耗电
zhuandu=欢度
zhuidui=汇兑
zhandong=涵洞
zfudai=附带
zfeidie=飞碟
zhuandeng=幻灯
zhuoda=豁达
zfadou=发抖
zhuadong=滑动
zhuidong=挥动
zfadian=法典
zfangdai=放贷
zhuadan=华诞
zhaidao=海盗
zhedan=核弹
zhengding=恒定
zhaodang=浩荡
zhuangdan=荒诞
zfaduan=发端
zfeidian=沸点
zhoudao=厚道
zhengdu=横渡
zfangdong=防冻
zhuduan=护短
zfandong=翻动
zhandian=函电
zhaodai=好歹
zhuodui=火堆
zfengdong=封冻
zfangdan=防弹
zhuadan=花旦
zhuaidan=坏蛋
zfudi=府第
zhoudai=厚待
zhendu=狠毒
zfangdang=放荡
zhundan=混蛋
zhudu=弧度
zhuidie=回跌
zhuangdang=晃荡
zhuoduan=祸端
zfeidan=飞弹
zhundan=浑蛋
zfahui=发挥
zfuhe=符合
zhuifu=恢复
zfenfen=纷纷
zhuihuang=辉煌
zfanhui=返回
zhunhe=混合
zhuhuan=呼唤
zhaohua=豪华
zfanghong=防洪
zhuahui=花卉
zfangfu=仿佛
zfenghuang=凤凰
zfanhua=繁华
zhuihua=绘画
zfuhe=负荷
zfangfan=防范
zfuhao=符号
zhuanhe=缓和
zhuanfa=焕发
zfanhai=返还
zfenghou=丰厚
zfanghu=防护
zfanfan=翻番
zhuhui=互惠
zhuaihai=淮海
zhaha=哈哈
zhuanhuan=缓缓
zfahuo=发货
zhuanhu=欢呼
zfuhao=富豪
zfangfu=防腐
zhanghai=航海
zhaofei=耗费
zhenhen=狠狠
zhouhui=后悔
zfenfa=奋发
zhongfeng=洪峰
zfengfan=风范
zhanhu=含糊
zhuanghun=黄昏
zhehua=荷花
zhuanghou=皇后
zhunfang=混纺
zhuihuo=挥霍
zfengfan=风帆
zfuhua=孵化
zhuihao=挥毫
zhuifa=挥发
zhaohan=浩瀚
zhuofo=活佛
zhanhou=憨厚
zhefan=盒饭
zhengfu=横幅
zfenhong=分洪
zfenfan=纷繁
zhehuan=和缓
zfenfang=芬芳
zfanhou=饭后
zhaofang=豪放
zhuohou=火候
zhuhang=护航
zhuanhui=换汇
zfenfu=吩咐
zfafen=发奋
zfenghuo=烽火
zhuihe=汇合
zfanhe=饭盒
zfenghe=缝合
zhunhou=浑厚
zfuhan=复函
zfenfei=纷飞
zfeifu=肺腑
zfanfa=犯法
zhuanghuang=惶惶
zhouhuan=后患
zhaofan=浩繁
zhuihui=会徽
zhuihen=悔恨
zhufa=护法
zhuangfei=荒废
zhuhu=糊糊
zhuanghu=恍惚
zfuhua=腐化
zfafeng=发疯
zfanhang=返航
zfafen=发愤
zfanfu=繁复
zhuohai=祸害
zfenhui=焚毁
zhuanghuo=惶惑
zfanfan=泛泛
zhehuan=合欢
zhehu=呵护
zhanhai=瀚海
zhonghuang=洪荒
zfeihou=肥厚
zheihei=嘿嘿
zfenfen=愤愤
zfufa=伏法
zfuhuo=俘获
zfuhe=附和
zhunhuang=昏黄
zfeihua=废话
zhuanhua=幻化
zfenhen=愤恨
zhuihong=恢弘
zfahuang=发慌
zfanhui=反悔
zhuohuan=祸患
zfenhao=分毫
zfanhao=番号
zfuhua=浮华
zfufen=福分
zhaofu=豪富
zfeihong=绯红
zhenghuo=横祸
zfangfei=芳菲
zhuifan=回返
zfenghai=奉还
zhuafang=画舫
zhehe=呵呵
zfufan=浮泛
zhuanghua=谎话
zfufang=付方
zhufu=虎符
zhunhao=诨号
zfagui=法规
zhongguan=宏观
zhanguo=韩国
zhege=合格
zfengge=风格
zfugai=覆盖
zfenge=分割
zhuoguo=火锅
zhuanggua=黄瓜
zfugei=付给
zfanguan=饭馆
zfanggu=仿古
zhengguan=横贯
zfagao=发稿
zfugui=富贵
zfangun=翻滚
zhangai=涵盖
zhonggan=烘干
zhuangguan=皇冠
zfenge=分隔
zfangui=犯规
zhangong=焊工
zhuanggong=皇宫
zhuagui=华贵
zhuogui=货柜
zfangong=返工
zhonggou=鸿沟
zhenggen=横亘
zhuigu=惠顾
zhuogen=祸根
zhanggui=行规
zhuagao=画稿
zhegu=何故
zhaogou=壕沟
zhuigai=悔改
zhuanguan=宦官
zhenggan=横杆
zfugao=讣告
zhuguang=弧光
zhuiguo=悔过
zheiguo=黑锅
zfenggou=疯狗
zfugao=腹稿
zhangou=函购
zhaigui=海龟
zfenggao=奉告
zfangong=翻供
zhuanjing=环境
zfujian=福建
zfujin=附近
zhuanjie=缓解
zfujia=附加
zhanjian=罕见
zhuojian=火箭
zfajue=发掘
zhuoju=火炬
zfojiao=佛教
zhanjie=焊接
zfenjin=奋进
zhuiji=汇集
zfujian=附件
zhuji=户籍
zhuangjia=皇家
zfajiao=发酵
zhenji=痕迹
zhuijia=汇价
zfeijiu=废旧
zfoujue=否决
zhuajia=花甲
zhuojia=货架
zhuiju=汇聚
zhuajiao=花椒
zhanjian=汉奸
zfenjiu=汾酒
zhanjian=函件
zhaojin=耗尽
zhaojie=浩劫
zhuanju=欢聚
zhuaji=滑稽
zhaijiang=海疆
zhaojie=豪杰
zfenjie=分界
zhunji=混迹
zhuanjue=幻觉
zhoujiao=吼叫
zhunjin=混进
zfeijian=飞溅
zfuji=伏击
zfojing=佛经
zfanjian=翻建
zhongji=轰击
zhuijin=灰烬
zhangju=行距
zhuijing=回敬
zhanji=旱季
zhunjue=昏厥
zhuangjiao=荒郊
zhuajiao=花轿
zhoujie=喉结
zhuoji=货机
zfangjin=方巾
zfanjie=反诘
zfanji=犯忌
zhuanjing=幻境
zhuanjing=幻景
zhaojie=耗竭
zhuajing=画境
zhuajing=化境
zhaoju=豪举
zhunjun=昏君
zfanjin=犯禁
zfanjie=犯戒
zhengji=哼唧
zhouji=猴急
zhangkong=航空
zhuokuan=货款
zfankui=反馈
zfukuan=付款
zhekuang=何况
zfankai=翻开
zhuikuan=汇款
zfengkuang=疯狂
zfankang=反抗
zhuankuai=欢快
zhaoke=毫克
zfukua=浮夸
zhengkua=横跨
zfenkai=愤慨
zheka=贺卡
zhukou=糊口
zhuikao=会考
zfukan=俯瞰
zhongkao=烘烤
zheku=何苦
zhuangkong=惶恐
zhuokeng=火坑
zfuke=复课
zfenkeng=粪坑
zfangkuang=方框
zhuokou=豁口
zfumu=父母
zhuanman=缓慢
zhaomi=毫米
zfengmao=风貌
zfanmang=繁忙
zhaoma=号码
zfanmai=贩卖
zhuangmo=荒漠
zfengmi=风靡
zhunmi=昏迷
zfengming=奉命
zhongming=轰鸣
zfamen=阀门
zfenmi=分泌
zhemu=和睦
zfengmi=蜂蜜
zhuimie=毁灭
zfangmu=放牧
zhaomen=豪门
zhaomai=豪迈
zhuimou=回眸
zfenmian=分娩
zfenmu=坟墓
zfumo=抚摸
zfengmang=锋芒
zfanmao=繁茂
zfamu=伐木
zhangmo=航模
zhuangmiu=荒谬
zfamei=发霉
zhuomian=豁免
zfama=砝码
zhuangmang=慌忙
zhuomiao=火苗
zhanmo=翰墨
zfumie=覆灭
zfenmen=愤懑
zhemiao=禾苗
zfamang=法盲
zhemou=合谋
zhuomai=活埋
zfenmu=分母
zfomen=佛门
zhuanmie=幻灭
zheimu=黑幕
zhaomiao=浩渺
zhanmao=汗毛
zhama=蛤蟆
zhenming=狠命
zfanmen=烦闷
zhaomao=毫毛
zhongmao=鸿毛
zhuamei=话梅
zfumo=抚摩
zfuming=浮名
zhunming=诨名
zfenpei=分配
zfupin=扶贫
zhuapo=滑坡
zhubo=湖泊
zhuopo=活泼
zhuipiao=汇票
zhepan=河畔
zhupan=湖畔
zfeipin=废品
zfeipang=肥胖
zhupo=琥珀
zhuopin=货品
zhuaping=花瓶
zhuapen=花盆
zfeipu=飞瀑
zhuapu=花圃
zhunpo=魂魄
zfapang=发胖
zhongpian=哄骗
zfengpei=丰沛
zhengpi=横批
zfanpan=反叛
zhuangpi=荒僻
zhunpei=婚配
zhuopen=火盆
zfangpi=放屁
zfuping=浮萍
zfengpei=奉陪
zfupin=副品
zfuqin=父亲
zhuaqiao=华侨
zfangqi=放弃
zhongqi=红旗
zfenqi=分歧
zhouqin=后勤
zfeiqi=废气
zhuanqi=唤起
zfengqu=风趣
zhuaquan=花圈
zfenqi=奋起
zfeiqi=废弃
zhanqing=旱情
zfanqie=番茄
zhuanqing=欢庆
zhaoqing=豪情
zfuqing=付清
zfanqi=泛起
zhongqiang=哄抢
zfuqi=福气
zfuqian=肤浅
zhaoqi=豪气
zhuanqi=缓期
zfengquan=奉劝
zfuqiao=浮桥
zhuangquan=黄泉
zhuiqi=晦气
zhuqin=胡琴
zhequ=河渠
zfeiqin=飞禽
zfanqian=饭前
zfengqun=蜂群
zhuanqiu=寰球
zhaqian=哈欠
zhaoqi=浩气
zfuqian=浮浅
zhaoqiang=豪强
zhuiqi=毁弃
zhuaqiang=花腔
zfanqing=烦请
zfuqi=付讫
zfangqi=房契
zhuiqi=悔棋
zhushi=忽视
zfushe=辐射
zfensan=分散
zhongshui=洪水
zhanshu=函数
zfangsong=放松
zhuangshan=荒山
zhanshui=汗水
zheshi=合适
zfusu=复苏
zfushu=附属
zfushi=服饰
zfushi=腐蚀
zfeishui=废水
zhushi=护士
zfushun=抚顺
zfengsuo=封锁
zfeisu=飞速
zfengshuo=丰硕
zhunshen=浑身
zfensui=粉碎
zfengsu=风俗
zfengsao=风骚
zfushi=副食
zhushui=湖水
zfanshen=翻身
zhanshou=函授
zfengshi=风湿
zfeisheng=蜚声
zhuoshi=伙食
zhuansan=涣散
zhaosheng=毫升
zfengshan=风扇
zhusong=护送
zfashi=发誓
zfuse=肤色
zhuoshao=火烧
zfashao=发烧
zhuosu=火速
zfenshao=焚烧
zfengsheng=丰盛
zhuishou=挥手
zhoushi=厚实
zheshan=和善
zhuansong=欢送
zhanshu=寒暑
zfushe=敷设
zhongshu=红薯
zfengsu=风速
zhuaishu=槐树
zhaoshuang=豪爽
zfansi=贩私
zfushe=附设
zfushu=富庶
zfusai=复赛
zfengshuang=风霜
zhuisa=挥洒
zhongshao=红烧
zhuoshi=获释
zhuisun=毁损
zfushi=俯视
zfenshua=粉刷
zfushou=扶手
zhoushe=喉舌
zhuangshi=皇室
zhuose=货色
zfangshe=房舍
zhanshan=汗衫
zhansuan=寒酸
zfushui=赋税
zhengsao=横扫
zhangsu=航速
zhanshi=憾事
zfushou=俯首
zfangshao=放哨
zhuangshang=皇上
zhuisu=回溯
zfusang=扶桑
zfengsong=奉送
zhuanshi=环视
zfushi=服侍
zfenshi=粉饰
zfansheng=繁盛
zfeishui=沸水
zfeishou=肥瘦
zhuise=晦涩
zhunshui=昏睡
zhanshui=酣睡
zhengshu=横竖
zfushi=复试
zfushang=府上
zhoushen=候审
zhuashao=花哨
zhousheng=吼声
zfansuo=烦琐
zfangsong=仿宋
zhuoshe=火舌
zfushu=服输
zfangsi=放肆
zhaosun=耗损
zhuoshui=祸水
zfeishi=飞逝
zhaoshen=豪绅
zhanshe=寒舍
zhaoshou=皓首
zhuangshu=荒疏
zhuoshi=祸事
zfushui=凫水
zhaisao=害臊
zhousi=后嗣
zfusang=服丧
zhengsi=横死
zhangtian=航天
zfating=法庭
zhuitu=绘图
zhuotui=火腿
zfeiteng=沸腾
zhaitan=海滩
zhongtai=哄抬
zhetao=核桃
zfandan=反弹
zhuatong=话筒
zhongtu=宏图
zhutu=糊涂
zhetan=河滩
zhuangtang=荒唐
zhongtuo=烘托
zfentan=分摊
zhuanteng=欢腾
zhaitang=海棠
zfuti=扶梯
zhuatan=花坛
zfutou=斧头
zfanteng=翻腾
zhuitang=会堂
zfutu=附图
zfeitie=废铁
zhuntun=馄饨
zhaitun=海豚
zhaitong=孩童
zfute=伏特
zfanti=繁体
zfeiteng=飞腾
zhaiti=孩提
zhuaitai=怀胎
zhongtu=鸿图
zhaotao=嚎啕
zfeitu=匪徒
zhongtang=红糖
zhuotan=货摊
zhetang=荷塘
zhuati=滑梯
zfanting=饭厅
zhutian=湖田
zfentu=粪土
zfutian=伏天
zhoutou=喉头
zfutu=浮土
zfantong=饭桶
zhaotao=号啕
zfutu=浮屠
zhuatou=滑头
zhuotai=祸胎
zfanwei=范围
zhuowu=货物
zhongwei=宏伟
zhaiwan=海湾
zhaowu=毫无
zhuiwu=会晤
zfenwei=氛围
zfengwei=风味
zfangwei=防伪
zfeiwu=废物
zfanwan=饭碗
zhanwei=捍卫
zhouwang=厚望
zhuangwu=荒芜
zfeiwo=肥沃
zfuweng=富翁
zfengwo=蜂窝
zhuiwei=回味
zhuwei=护卫
zhuawen=花纹
zfengwang=蜂王
zhengwen=恒温
zfeiwu=飞舞
zhangwu=航务
zfanwen=范文
zhuiwu=挥舞
zfawei=乏味
zfuwei=抚慰
zhaiwei=海味
zhaoe=好恶
zfuwo=俯卧
zfanwen=梵文
zhuwei=虎威
zhuiwu=悔悟
zhuangwei=皇位
zfuwang=覆亡
zfeiwen=绯闻
zhanwen=罕闻
zfengxian=风险
zfengxian=奉献
zhuaxian=化纤
zhuoxu=或许
zhangxian=航线
zhuoxi=获悉
zhengxiang=横向
zhexie=和谐
zfangxun=防汛
zhuaxia=华夏
zhangxing=航行
zhaixia=海峡
zfenxiang=分享
zfengxing=奉行
zhuixing=彗星
zhuanxiang=幻想
zfuxiu=腐朽
zhuaxue=滑雪
zfanxiao=返销
zhexin=贺信
zfeixu=废墟
zfanxin=翻新
zhouxu=后续
zhaixian=海鲜
zhuanxing=唤醒
zfangxiao=仿效
zhuxiao=呼啸
zhunxiao=混淆
zhuanxi=欢喜
zfuxie=腹泻
zhengxing=横行
zhexie=河蟹
zfeixiang=飞翔
zhanxu=含蓄
zhuanxiao=欢笑
zfanxiu=翻修
zhuixuan=回旋
zfaxing=发型
zfuxu=抚恤
zfuxing=服刑
zhuixie=诙谐
zfengxi=缝隙
zfuxian=浮现
zhouxuan=候选
zhuxing=弧形
zfoxiang=佛像
zfangxing=方形
zhengxing=恒星
zhuanxing=缓刑
zfoxue=佛学
zhuaxiang=滑翔
zhenxin=狠心
zhaixiao=海啸
zhuaxing=滑行
zhangxiang=航向
zfanxing=繁星
zfaxie=发泄
zhanxuan=寒暄
zfanxiu=返修
zfenxiao=分晓
zfuxiao=拂晓
zhuixiang=茴香
zhuanxin=欢心
zhengxin=恒心
zfanxiao=返校
zhexi=贺喜
zhuanxi=换洗
zfeixuan=飞旋
zhexu=和煦
zhuaxu=花絮
zfuxiong=父兄
zhongxiang=轰响
zhuxian=弧线
zhaixiu=害羞
zfuxian=赋闲
zhuanxing=缓行
zfenxiang=焚香
zhuanxiang=幻象
zhengxian=横线
zhongxiao=哄笑
zhuxue=虎穴
zhunxing=荤腥
zfengxiang=风箱
zhanxian=汗腺
zhanxiu=含羞
zfuxi=父系
zhaoxia=豪侠
zfuxiang=福相
zfuxiu=拂袖
zhunxuan=昏眩
zhuiyi=会议
zfanying=反映
zhuanying=欢迎
zfuyu=富裕
zhuoyue=活跃
zhuyu=呼吁
zfayu=发育
zhongyang=弘扬
zfuyi=复议
zfuyu=赋予
zhuoyuan=货源
zhunyin=婚姻
zfanyi=翻译
zfeiyue=飞跃
zhuaiyi=怀疑
zhaiyu=海域
zhangyun=航运
zhuoyun=货运
zfangying=放映
zfanyun=贩运
zfangyi=防疫
zfangyu=防御
zfanyan=繁衍
zhuayan=化验
zfangyuan=方圆
zfuyou=妇幼
zfuyi=服役
zfuyang=抚养
zhuoyan=火焰
zfanyue=翻阅
zhuaiyun=怀孕
zfenyong=奋勇
zhuiyan=讳言
zhuayi=华裔
zhuayin=话音
zhuangyuan=荒原
zfengyong=蜂拥
zfuyin=福音
zfenyou=分忧
zfayin=发音
zhuoyi=获益
zhouyi=后裔
zfeiyi=非议
zhuiyan=慧眼
zhuiyin=回音
zhanyang=涵养
zfuyu=抚育
zhuangyan=谎言
zfengyun=风韵
zfeiyan=肺炎
zhuanying=幻影
zhuiying=辉映
zfaya=发芽
zfayi=法医
zheye=荷叶
zhuiyan=汇演
zfengye=枫叶
zhongyuan=宏愿
zfeiye=扉页
zfanyue=翻越
zfuyou=浮游
zhouyi=厚意
zhuangye=荒野
zfenyun=纷纭
zfuyan=敷衍
zhongyan=鸿雁
zfanyin=翻印
zfengying=丰盈
zhanyan=汗颜
zhuayuan=化缘
zfuyong=附庸
zfuyan=赴宴
zfengyu=丰腴
zhanyuan=含冤
zhanyou=罕有
zhuanyu=欢愉
zhengyi=横溢
zhunyuan=浑圆
zfuyan=附言
zhuanyang=豢养
zfuyu=馥郁
zhongyan=红颜
zfenying=坟茔
zhuanyu=寰宇
zfuyun=浮云
zhuoye=活页
zhaoyue=皓月
zhuangyou=晃悠
zhuiyou=洄游
zhuanyue=欢悦
zhengyue=横越
zhanyuan=喊冤
zhuoyang=货样
zhunyong=昏庸
zfangyan=房檐
zfengyang=奉养
zhuyou=护佑
zfuyi=附议
zhuangying=黄莺
zhuangyin=荒淫
zhuiyu=秽语
zfuying=服膺
zfengying=逢迎
zfanyi=犯疑
zhayao=哈腰
zfengyun=丰韵
zfuze=负责
zhaizi=孩子
zfanzui=犯罪
zfangzhi=纺织
zhuanzhe=患者
zhangzhou=杭州
zfeizhou=非洲
zfouze=否则
zfenzhong=分钟
zfuzhou=福州
zfuzhai=负债
zfuzhu=辅助
zhaozhao=号召
zfenzhan=奋战
zfangzhen=仿真
zhuzhu=互助
zfanzhong=繁重
zfanzhi=繁殖
zhezhun=核准
zfangzhi=仿制
zhuizong=汇总
zhuizhi=绘制
zfuzhi=扶植
zhaozi=耗资
zfeizhi=废止
zhuizu=回族
zhanzu=汉族
zfuze=附则
zhongzha=轰炸
zfanzi=贩子
zhanzai=旱灾
zfengzheng=风筝
zhuzhao=护照
zhuozhun=获准
zhongzai=洪灾
zhuozhu=货主
zfuzi=父子
zfangzu=房租
zfangzhi=放置
zhuizhen=会诊
zfuzhu=扶助
zfeizhi=废纸
zfangzhen=防震
zfeizha=废渣
zfanza=繁杂
zfuzhong=附中
zhongzao=红枣
zfuzhe=附着
zfeizao=肥皂
zfenzheng=纷争
zhouzhong=厚重
zhunza=混杂
zhezi=盒子
zhuangzi=幌子
zhuozang=火葬
zfengzi=风姿
zhaizao=海藻
zfanzhuo=饭桌
zhouzi=猴子
zfuzhong=浮肿
zhunzhuo=混浊
zfuzao=浮躁
zhanzhu=汗珠
zfangzao=仿造
zfangzhao=仿照
zfanzao=烦躁
zfanzhuan=翻转
zhunzhan=混战
zfuzhu=附注
zhaozi=耗子
zfangzhou=方舟
zhunzhuo=浑浊
zhuangzhang=慌张
zfanzhi=泛指
zhezou=合奏
zfengzi=疯子
zhuizhang=徽章
zfuzi=斧子
zhezi=赫兹
zhuizhi=回执
zhuangzu=皇族
zhaizhe=海蜇
zfozu=佛祖
zfangzhuo=方桌
zfuzuo=辅佐
zfengzi=丰姿
zfenzang=分赃
zhuozhan=货栈
zfangzhu=放逐
zhuizui=悔罪
zfeizhuang=肥壮
zfenza=纷杂
zhouzhui=后缀
zhanzhan=酣战
zfeizhi=废置
zfeizi=妃子
zheizhi=黑痣
zfuzhang=付账
zhaizang=海葬
zhunzhang=混账
zgaoang=高昂
zganai=肝癌
zgaoai=高矮
zgaoao=高傲
zguao=孤傲
zgeai=割爱
zgouan=苟安
zguer=故而
zganen=感恩
zgonge=宫娥
zguli=鼓励
zguilv=规律
zgainian=概念
zguangrong=光荣
zguanli=惯例
zganrao=干扰
zganran=感染
zguilin=桂林
zguolu=锅炉
zguanglan=光缆
zguran=固然
zgeli=隔离
zguina=归纳
zgangling=纲领
zgaoling=高龄
zguolv=过滤
zgulv=顾虑
zgaoliang=高粱
zguli=故里
zganlan=橄榄
zguanliao=官僚
zgonglao=功劳
zguanglin=光临
zgailv=概率
zguangliang=光亮
zgoulei=勾勒
zgulou=鼓楼
zgere=隔热
zgurou=骨肉
zgelie=割裂
zgailun=概论
zguinv=闺女
zguili=瑰丽
zgongnuan=供暖
zganlu=甘露
zganlu=赶路
zguanli=官吏
zguanli=观礼
zgangling=杠铃
zguren=故人
zgelv=格律
zjunlie=龟裂
zganlin=甘霖
zguorou=果肉
zgoulou=佝偻
zguiren=贵人
zgerang=割让
zganlie=干裂
zgelou=阁楼
zganglie=刚烈
zgulu=咕噜
zgailve=概略
zgeri=隔日
zguaili=乖戾
zgunong=咕哝
zguolv=过虑
zgunre=滚热
zgulu=骨碌
zgongbu=公布
zguangbo=广播
zguanbing=官兵
zgaobie=告别
zgangbi=港币
zgangban=钢板
zguibin=贵宾
zgebi=戈壁
zguangbiao=光标
zgebo=胳膊
zguobao=国宝
zguibao=瑰宝
zguobiao=国标
zguangbo=广博
zgebi=隔壁
zgunbang=棍棒
zguoba=锅巴
zguibi=规避
zgeban=隔板
zguobang=过磅
zguibai=跪拜
zguban=古板
zganbie=干瘪
zguibian=诡辩
zgebei=胳臂
zguocheng=过程
zguanche=贯彻
zguancha=观察
zgangcai=钢材
zgaochao=高潮
zguance=观测
zguangcai=光彩
zgancui=干脆
zguanchuan=贯穿
zguicheng=规程
zganchu=感触
zganchao=赶超
zgongchen=功臣
zguchui=鼓吹
zguancai=棺材
zguoce=国策
zgaoci=告辞
zguocui=国粹
zguci=故此
zgongchi=公尺
zgaochui=告吹
zguacai=挂彩
zguanchang=惯常
zguce=估测
zguanchang=灌肠
zgechu=割除
zguicheng=归程
zguiding=规定
zgengdi=耕地
zguodu=过渡
zguding=固定
zgandao=赶到
zgundong=滚动
zgudian=古典
zgediao=格调
zgaodian=糕点
zgudong=鼓动
zgeda=疙瘩
zgongdian=宫殿
zgudong=古董
zgeduan=割断
zgoudang=勾当
zgandang=甘当
zgengdie=更迭
zguandi=官邸
zgangdu=港督
zgoudui=勾兑
zgedou=格斗
zgeduan=隔断
zgendiao=根雕
zgudi=故地
zgudao=鼓捣
zgede=割地
zgundan=滚蛋
zgudu=咕嘟
zguaidai=拐带
zgouda=勾搭
zguihua=规划
zguifan=规范
zgaofeng=高峰
zganhan=干旱
zguanghui=光辉
zganfu=赶赴
zgufu=辜负
zganhui=赶回
zguohuo=国货
zguihua=桂花
zguhua=固化
zgaofei=稿费
zgouhua=勾画
zguanghua=光滑
zguafen=瓜分
zguohui=国徽
zgouhe=沟壑
zganhe=干涸
zguafeng=刮风
zgonghao=功耗
zgehou=歌喉
zgehe=隔阂
zgongfeng=供奉
zguanfu=官府
zgouhuo=篝火
zguofu=果脯
zgonghou=恭候
zgaofa=告发
zgonghan=公函
zguanfan=惯犯
zguafu=寡妇
zgonghe=恭贺
zgouhe=媾和
zgongfen=公愤
zgaihua=钙化
zguihun=鬼混
zguifang=闺房
zgufu=姑父
zguofu=果腹
zguihun=鬼魂
zgouhe=苟合
zguanfu=鳏夫
zgonggu=巩固
zguige=规格
zguangai=灌溉
zguagou=挂钩
zgonggao=公告
zgungun=滚滚
zguiguan=桂冠
zganga=尴尬
zguaguo=瓜果
zganggan=杠杆
zgugong=故宫
zgaogui=高贵
zgugua=孤寡
zgugong=雇工
zguge=骨骼
zguiguo=贵国
zguigu=硅谷
zguoge=国格
zguanggun=光棍
zguaiguai=乖乖
zgengu=亘古
zguogai=锅盖
zguguo=故国
zguaigun=拐棍
zgange=干戈
zgenggai=梗概
zguage=瓜葛
zgangong=赶工
zgonggu=肱骨
zguoguo=蝈蝈
zgaiguan=概观
zgongjin=公斤
zguanjian=关键
zgeju=格局
zgejie=各界
zguanjun=冠军
zgongjian=攻坚
zgaojian=稿件
zganjing=干净
zguji=古迹
zganji=感激
zgaojie=告诫
zguji=古籍
zguiji=轨迹
zguoji=国籍
zguiju=规矩
zgangjin=钢筋
zganjin=赶紧
zguju=故居
zguojie=国界
zgongji=功绩
zgaoji=告急
zgoujie=勾结
zgujin=鼓劲
zguojing=国境
zgejue=隔绝
zguangjie=光洁
zgaojie=告捷
zgeju=割据
zganji=赶集
zguji=痼疾
zguangjie=逛街
zguji=顾忌
zguoji=过激
zguijian=贵贱
zguojiang=果酱
zgongjing=恭敬
zgongjian=弓箭
zgujiu=故旧
zganju=柑橘
zgaojun=高峻
zgangjian=刚健
zguaijiao=拐角
zgaojia=告假
zguijue=诡谲
zguiji=诡计
zguijiu=归咎
zguijia=龟甲
zgongjin=恭谨
zguojiao=裹脚
zguangkuo=广阔
zgaikuo=概括
zgankai=感慨
zgaokao=高考
zgaikuang=概况
zgankuai=赶快
zganku=甘苦
zgongke=功课
zgekai=隔开
zgaokang=高亢
zganke=干渴
zguike=贵客
zgaokua=搞垮
zguankui=管窥
zguku=孤苦
zgankui=感喟
zgankao=赶考
zgangkui=钢盔
zgunkai=滚开
zguimo=规模
zgongmu=公墓
zganmao=感冒
zguangmang=光芒
zgongming=共鸣
zguanmo=观摩
zguaimai=拐卖
zguanmu=灌木
zguangmao=广袤
zguomin=过敏
zgemo=隔膜
zguimi=诡秘
zgaomi=告密
zgongmian=共勉
zgaimao=概貌
zganmei=甘美
zgumo=估摸
zgumu=姑母
zgongmen=拱门
zgenmiao=根苗
zguangmo=广漠
zguopin=果品
zgongpu=公仆
zgaopin=高频
zgupu=古朴
zgaipan=改判
zgongpo=公婆
zgongpin=贡品
zgupi=孤僻
zguaipian=拐骗
zguapi=瓜皮
zgongpan=公判
zgupan=顾盼
zgongpin=供品
zgaopan=高攀
zguaipi=怪癖
zguaipi=怪僻
zgoupi=狗屁
zguaipi=乖僻
zguoqi=国旗
zgangqin=钢琴
zguiqiao=归侨
zguaiquan=怪圈
zgeqian=搁浅
zgouqi=枸杞
zgouqu=沟渠
zguiquan=规劝
zgouqian=勾芡
zgongqiao=拱桥
zguangquan=光圈
zguaiqiao=乖巧
zgangqiao=刚巧
zgouqie=苟且
zgongque=宫阙
zguanqiang=官腔
zguanqie=惯窃
zgongsi=公司
zgaishan=改善
zgaosu=高速
zgaosu=告诉
zgushi=故事
zgansu=甘肃
zgongshi=共识
zganshe=干涉
zganshang=赶上
zguanshang=观赏
zguansi=官司
zgeshi=格式
zguosheng=过剩
zguashuai=挂帅
zgesong=歌颂
zguixiu=归宿
zgaoshao=高烧
zgusui=骨髓
zgaosong=高耸
zgushou=固守
zgaoshi=告示
zgongshou=拱手
zgaishu=概述
zguanshu=灌输
zgengsai=梗塞
zguanshu=管束
zganshu=甘薯
zgaoshou=高寿
zgaoseng=高僧
zgangshao=岗哨
zgushou=鼓手
zgongshu=公署
zguangsu=光速
zgaishi=盖世
zgeshi=隔世
zganshou=干瘦
zgusao=姑嫂
zguanshu=官署
zguasha=刮痧
zguanshen=官绅
zganse=干涩
zguisuo=龟缩
zguoshang=国殇
zgongshun=恭顺
zgoutong=沟通
zguitai=柜台
zguantou=罐头
zguti=固体
zguantong=贯通
zgongting=宫廷
zgutu=故土
zgetan=歌坛
zgutai=固态
zguntang=滚烫
zguntong=滚筒
zgantian=甘甜
zgoutong=苟同
zguitu=归途
zgangting=岗亭
zgaotui=告退
zguatou=寡头
zgongtui=公推
zguwu=鼓舞
zgaowen=高温
zgewu=歌舞
zgewai=格外
zganwang=赶往
zgangwan=港湾
zganwu=感悟
zgaowei=告慰
zgaowan=睾丸
zgongwei=恭维
zguaiwan=拐弯
zgongxian=贡献
zgaoxiao=高效
zganxie=感谢
zguxiang=故乡
zguanxia=管辖
zguangxian=光纤
zgongxiang=共享
zgongxin=工薪
zgongxiao=功效
zgaoxin=高薪
zgongxun=功勋
zguanxing=惯性
zgexia=阁下
zguxi=姑息
zguxi=古稀
zguxi=股息
zguixia=跪下
zganxin=甘心
zgongxi=恭喜
zgongxing=拱形
zgongxian=攻陷
zgouxiong=狗熊
zguanxi=盥洗
zguixing=贵姓
zguanxian=官衔
zguxi=顾惜
zjiyu=给予
zganyu=干预
zgongyi=公益
zguiyang=贵阳
zguyi=故意
zgengyun=耕耘
zgongyu=公寓
zguyuan=雇员
zguyou=固有
zguyong=雇佣
zguyong=雇用
zganyuan=甘愿
zgeyan=格言
zgengye=哽咽
zgule=鼓乐
zganyu=甘于
zgongyan=公演
zgeyao=歌谣
zgangyi=刚毅
zgeyong=歌咏
zguoyan=国宴
zgaiyao=概要
zguanyong=惯用
zgeyin=隔音
zguoyin=过瘾
zguiyuan=桂圆
zguaiyi=怪异
zguyuan=故园
zgaoyao=膏药
zgaoyang=羔羊
zgeye=隔夜
zgouyin=勾引
zguyou=故友
zguayan=寡言
zgongying=恭迎
zguiyi=诡异
zgunyuan=滚圆
zguangzhou=广州
zguanzhong=观众
zguozhai=国债
zguizhou=贵州
zguize=规则
zgongzhong=公众
zgezu=各族
zguzhang=故障
zgenzong=跟踪
zgouzhi=购置
zguizhang=规章
zgouzhu=构筑
zganzao=干燥
zguizu=贵族
zganzhe=甘蔗
zgongzhang=公章
zgaozhi=告知
zgengzhong=耕种
zguzhu=雇主
zguangze=光泽
zguozhi=果汁
zganzhao=感召
zgaozi=稿子
zguizhong=贵重
zguzhang=鼓掌
zgaozhuang=告状
zgezi=鸽子
zguanzhao=关照
zguangzhao=光照
zgongzhen=共振
zgaizhang=盖章
zguazi=瓜子
zganzang=肝脏
zguaizhang=拐杖
zgezhi=搁置
zgaozhong=告终
zguanzhu=灌注
zgezi=格子
zguanzhuang=罐装
zgunzi=棍子
zgengzu=梗阻
zgongzhai=公债
zguzhi=固执
zgongzheng=工整
zguizi=柜子
zganzi=杆子
zganzou=赶走
zgaozu=高祖
zgengzhi=耿直
zgaozhi=稿纸
zguanzi=罐子
zguzao=鼓噪
zgaizi=盖子
zguzu=鼓足
zguizui=归罪
zguanzhu=贯注
zganzi=竿子
zguzhang=鼓胀
zguaizui=怪罪
zguozao=聒噪
zgouzi=钩子
zgongzhuo=供桌
zguozang=国葬
zguazi=褂子
zguizheng=归整
zguizha=诡诈
zguizhi=归置
zgaozui=告罪
zjiaoao=骄傲
zjingai=敬爱
zjiang=激昂
zjianao=煎熬
zjian=积案
zjieai=节哀
zjuao=倨傲
zjue=巨额
zjianer=健儿
zjie=饥饿
zjinge=惊愕
zjiaoer=焦耳
zjilie=激烈
zjilei=积累
zjiangli=奖励
zjingnei=境内
zjuli=距离
zjilv=纪律
zjingli=精力
zjili=激励
zjinan=济南
zjineng=技能
zjiaona=缴纳
zjianli=监理
zjiaona=交纳
zjianrui=尖锐
zjianlou=简陋
zjianrong=兼容
zjuren=巨人
zjielu=揭露
zjiena=接纳
zjuliu=拘留
zjulie=剧烈
zjirou=肌肉
zjianglin=降临
zjiaonang=胶囊
zjingliang=精良
zjieliu=截留
zjieli=竭力
zjiaolv=焦虑
zjuli=举例
zjinglv=劲旅
zjiliang=脊梁
zjiangling=将领
zjiliu=激流
zjiren=己任
zjingluo=经络
zjiliang=剂量
zjierang=接壤
zjuanlian=眷恋
zjinlin=近邻
zjianren=坚韧
zjieliu=截流
zjirou=鸡肉
zjunlv=军旅
zjiana=加纳
zjianli=简历
zjingran=井然
zjianru=键入
zjingli=敬礼
zjingling=精灵
zjieran=截然
zjiaolong=蛟龙
zjianlian=简练
zjienan=劫难
zjuni=拘泥
zjingrui=精锐
zjinv=妓女
zjinglian=精练
zjuelun=绝伦
zjianlve=简略
zjingluan=痉挛
zjiali=佳丽
zjinrun=浸润
zjinlin=紧邻
zjiaren=佳人
zjiliang=伎俩
zjinu=激怒
zjialun=加仑
zjiaoluan=搅乱
zjuelie=决裂
zjina=缉拿
zjulong=聚拢
zjiaorang=叫嚷
zjunling=峻岭
zjianiang=佳酿
zjielv=戒律
zjunli=军礼
zjinran=浸染
zjunrong=军容
zjilu=辑录
zjinliang=斤两
zjulian=聚敛
zjielve=劫掠
zjiaran=戛然
zjiaonen=娇嫩
zjianlao=监牢
zjunling=军龄
zjiongran=迥然
zjiaoliao=脚镣
zjuanrong=倦容
zjingrao=惊扰
zjienan=诘难
zjiliao=寂寥
zjianren=坚忍
zjiri=忌日
zjiaorou=娇柔
zjuran=遽然
zjiliu=羁留
zjuannian=眷念
zjialin=驾临
zjianliang=见谅
zjielie=节烈
zjubei=具备
zjianbian=简便
zjianbie=鉴别
zjubian=巨变
zjibai=击败
zjianbao=简报
zjiaoban=搅拌
zjiebai=洁白
zjingbing=精兵
zjingbei=警备
zjianbang=肩膀
zjiebao=捷报
zjiabin=嘉宾
zjiaban=甲板
zjianbei=兼备
zjunbei=军备
zjieban=结伴
zjiebei=戒备
zjubian=聚变
zjiban=羁绊
zjianbing=尖兵
zjibi=击毙
zjubu=拘捕
zjinbi=金币
zjianbao=剪报
zjinbang=金榜
zjinbi=紧逼
zjuebi=绝壁
zjiaban=夹板
zjibei=脊背
zjiaobu=胶布
zjinbo=金箔
zjiebei=界碑
zjubo=巨擘
zjinbi=进逼
zjianbu=箭步
zjuebie=诀别
zjiaobian=教鞭
zjiaoban=叫板
zjiebang=揭榜
zjianbian=简编
zjibu=缉捕
zjibi=积弊
zjiaobian=狡辩
zjiebiao=界标
zjinbiao=锦标
zjiebai=结拜
zjubu=拒捕
zjibian=激变
zjianbie=饯别
zjianben=简本
zjieba=结疤
zjiubing=救兵
zjiabing=甲兵
zjichu=基础
zjianchi=坚持
zjuece=决策
zjincheng=进程
zjiancai=建材
zjiaoche=轿车
zjiance=检测
zjiechu=接触
zjiance=监测
zjiancha=检察
zjucuo=举措
zjiancheng=简称
zjiancha=监察
zjingcha=警察
zjiaocai=教材
zjieceng=阶层
zjiaocha=交叉
zjingcai=精彩
zjiangcheng=奖惩
zjiancai=剪彩
zjicha=稽查
zjiucan=就餐
zjicun=寄存
zjiancheng=兼程
zjiachu=家畜
zjiuchan=纠缠
zjincou=紧凑
zjiechi=劫持
zjiecheng=竭诚
zjicang=机舱
zjiucai=韭菜
zjuecha=觉察
zjiangcai=酱菜
zjingcheng=精诚
zjicu=急促
zjincan=进餐
zjingcha=惊诧
zjichou=计酬
zjiaoche=绞车
zjicun=积存
zjiaceng=夹层
zjiancai=剪裁
zjiaocheng=教程
zjiangchi=僵持
zjingcui=精粹
zjucan=聚餐
zjiangchang=疆场
zjiucha=纠察
zjiechuan=揭穿
zjichi=疾驰
zjinchi=矜持
zjuchi=锯齿
zjiechu=戒除
zjucu=局促
zjiecao=节操
zjiachou=家丑
zjianchu=剪除
zjicha=缉查
zjiechao=解嘲
zjice=计策
zjianchen=奸臣
zjiuchi=臼齿
zjichou=记仇
zjiechou=结仇
zjiandu=监督
zjieduan=阶段
zjuda=巨大
zjianding=鉴定
zjiandan=简单
zjidong=激动
zjianding=坚定
zjiaodian=焦点
zjidan=鸡蛋
zjieding=界定
zjingdu=精度
zjidai=亟待
zjiduan=极端
zjiandui=舰队
zjingdi=境地
zjingdian=经典
zjiedai=借贷
zjianduan=尖端
zjingdian=静电
zjiandie=间谍
zjiandao=剪刀
zjianduan=简短
zjidang=激荡
zjidu=缉毒
zjidian=祭奠
zjidu=嫉妒
zjidu=基督
zjiedong=解冻
zjiedi=姐弟
zjiadao=夹道
zjieduan=截断
zjiadai=夹带
zjingdi=警笛
zjiaodong=搅动
zjide=积德
zjieduan=揭短
zjingdu=精读
zjinduan=锦缎
zjindou=筋斗
zjidui=挤兑
zjiedi=芥蒂
zjuandai=倦怠
zjudu=聚赌
zjidu=忌妒
zjidan=忌惮
zjiufen=纠纷
zjifa=激发
zjinghua=净化
zjiaofu=交付
zjinhuo=进货
zjiaohuo=交货
zjianhua=简化
zjunheng=均衡
zjinghua=精华
zjifen=积分
zjiafang=甲方
zjuhui=聚会
zjuhua=菊花
zjiaohui=交汇
zjihua=激化
zjianghu=江湖
zjifa=技法
zjianhuan=减缓
zjiehui=结汇
zjiaohuo=缴获
zjiuhu=救护
zjihe=稽核
zjianghua=僵化
zjiefa=揭发
zjiahua=佳话
zjiaofeng=交锋
zjihuo=激活
zjunfa=军阀
zjiaohui=教诲
zjufu=巨幅
zjianhu=监护
zjingfang=精纺
zjufu=拒付
zjiafeng=夹缝
zjinfang=谨防
zjiahou=加厚
zjihui=忌讳
zjifu=肌肤
zjiaohua=狡猾
zjinghuang=惊慌
zjiehuo=截获
zjifeng=讥讽
zjiefang=街坊
zjihuang=饥荒
zjufeng=飓风
zjiehuo=解惑
zjifen=激愤
zjinhuai=襟怀
zjifu=继父
zjiafu=家父
zjiufan=就范
zjiefu=姐夫
zjianghu=浆糊
zjiufu=舅父
zjiaofei=剿匪
zjinfan=进犯
zjiefei=劫匪
zjinghan=精悍
zjiuhe=纠合
zjihuo=缉获
zjunhui=军徽
zjiaohuan=叫唤
zjinghe=敬贺
zjinghai=惊骇
zjiaofu=教父
zjinghuang=惊惶
zjiaoheng=骄横
zjiaohao=姣好
zjifang=寄放
zjiaohuang=焦黄
zjiaohuo=搅和
zjiaofu=轿夫
zjiaohan=娇憨
zjihen=嫉恨
zjiuhuang=韭黄
zjingfeng=敬奉
zjuhong=橘红
zjiefa=解乏
zjiahuo=嫁祸
zjifei=寄费
zjiage=价格
zjungong=竣工
zjiguang=激光
zjianguan=监管
zjinggao=警告
zjigong=技工
zjiagu=加固
zjinggan=精干
zjiangong=监工
zjinguo=巾帼
zjiange=间隔
zjiaoge=交割
zjiangu=坚固
zjiaoguan=浇灌
zjingu=禁锢
zjiegu=解雇
zjugong=鞠躬
zjiagui=家规
zjige=及格
zjiuge=纠葛
zjingu=筋骨
zjiguan=籍贯
zjianggao=讲稿
zjiangge=降格
zjiegu=借故
zjinggun=警棍
zjiegao=截稿
zjiguan=鸡冠
zjingguang=精光
zjingguan=静观
zjianguo=坚果
zjiagong=夹攻
zjiaoguan=娇惯
zjiaogui=娇贵
zjigu=叽咕
zjuangu=眷顾
zjingji=经济
zjiji=积极
zjianjue=坚决
zjiejian=借鉴
zjujue=拒绝
zjiujing=究竟
zjianju=艰巨
zjieji=阶级
zjiangjiu=讲究
zjiuji=救济
zjingjie=境界
zjuji=聚集
zjiejing=结晶
zjingjian=精简
zjiujing=酒精
zjingji=竞技
zjingjiao=京郊
zjiejie=姐姐
zjiaojie=交界
zjuju=聚居
zjianjie=简介
zjingjie=警戒
zjingjing=静静
zjieji=劫机
zjinjiao=近郊
zjiaji=佳绩
zjiejing=洁净
zjianjie=简洁
zjiejing=捷径
zjiajiang=嘉奖
zjiajie=佳节
zjiajing=家境
zjiaoji=焦急
zjueji=绝迹
zjinji=晋级
zjiejian=节俭
zjieju=拮据
zjujiao=聚焦
zjiongjing=窘境
zjianju=间距
zjunjian=军舰
zjiangju=僵局
zjingjia=井架
zjiujiu=舅舅
zjujue=咀嚼
zjueji=绝技
zjiju=积聚
zjinji=禁忌
zjijing=寂静
zjingji=荆棘
zjujin=拘禁
zjuejing=绝境
zjuejiang=倔强
zjiaojian=矫健
zjijin=激进
zjianjin=监禁
zjiajiao=夹角
zjunjie=俊杰
zjiongjiong=炯炯
zjujin=拘谨
zjiajing=佳境
zjiaji=夹击
zjianjiang=健将
zjiejin=竭尽
zjiuji=纠集
zjianjie=简捷
zjieji=接济
zjiangjie=疆界
zjujian=举荐
zjujiang=巨匠
zjingjiu=敬酒
zjijin=集锦
zjieji=截击
zjianji=剪辑
zjiju=寄居
zjiaju=佳句
zjijiao=犄角
zjiaoju=焦距
zjiaojie=皎洁
zjunji=军籍
zjuji=聚积
zjianjia=肩胛
zjianjie=剪接
zjiaojiao=皎皎
zjiujie=纠结
zjiajuan=家眷
zjingji=惊悸
zjuji=狙击
zjinjian=晋见
zjianji=奸计
zjianju=荐举
zjiankang=健康
zjianku=艰苦
zjuankuan=捐款
zjiankong=监控
zjinkuang=金矿
zjiekai=揭开
zjiangke=讲课
zjiku=疾苦
zjukuan=巨款
zjuanke=镌刻
zjiake=夹克
zjike=即刻
zjingkuang=境况
zjieke=解渴
zjingkong=惊恐
zjiaoku=叫苦
zjike=饥渴
zjinkuang=近况
zjingkuang=镜框
zjingkuang=景况
zjiaokan=校勘
zjiankuang=简况
zjianke=尖刻
zjiaoke=教课
zjiankao=监考
zjianke=兼课
zjikui=击溃
zjiankong=检控
zjinmi=紧密
zjiamao=假冒
zjianmian=减免
zjingmei=精美
zjingmi=精密
zjiemei=姐妹
zjingming=精明
zjiemian=界面
zjimo=寂寞
zjiemu=揭幕
zjianmei=健美
zjingmai=静脉
zjimi=机密
zjiman=挤满
zjunma=骏马
zjianming=简明
zjiaomo=角膜
zjiaomu=酵母
zjiami=加密
zjiama=加码
zjiama=价码
zjianmie=歼灭
zjimin=机敏
zjuemiao=绝妙
zjiaomei=焦煤
zjimu=积木
zjuemi=绝密
zjimu=继母
zjiemi=解密
zjunmei=俊美
zjiemao=睫毛
zjianmo=缄默
zjimin=饥民
zjimai=寄卖
zjingmai=经脉
zjiamian=嘉勉
zjingmo=静默
zjiamian=加冕
zjiaomei=娇媚
zjiaomie=剿灭
zjimou=计谋
zjiaomei=姣美
zjiuma=舅妈
zjiumu=舅母
zjingpin=精品
zjinpo=紧迫
zjianpan=键盘
zjiepou=解剖
zjingpei=敬佩
zjianpu=简朴
zjingpi=精辟
zjiangpin=奖品
zjinpao=浸泡
zjiapin=佳品
zjiepin=解聘
zjianpu=俭朴
zjingpian=镜片
zjiongpo=窘迫
zjipo=急迫
zjupa=惧怕
zjiapu=家谱
zjipin=极品
zjiaopei=交配
zjianpu=简谱
zjiaopan=绞盘
zjiepi=洁癖
zjianquan=健全
zjueqi=崛起
zjiaoqu=郊区
zjianqiang=坚强
zjiqiao=技巧
zjiqing=激情
zjingque=精确
zjiqi=激起
zjiqu=汲取
zjiaqin=家禽
zjinqiao=紧俏
zjinqi=锦旗
zjiangquan=奖券
zjingqiao=精巧
zjuquan=俱全
zjueqiao=诀窍
zjianqu=渐趋
zjuequ=攫取
zjieqia=接洽
zjiaquan=甲醛
zjuanqu=捐躯
zjunqi=军旗
zjiaqiao=甲壳
zjingquan=警犬
zjiequ=截取
zjunqiao=俊俏
zjiuqin=就寝
zjiaoqi=娇气
zjingqiang=京腔
zjiaoqing=矫情
zjiaqi=佳期
zjiaoqu=叫屈
zjiangqi=降旗
zjunqiao=峻峭
zjiaoqi=骄气
zjianqing=奸情
zjiqie=姬妾
zjishu=技术
zjingshen=精神
zjieshao=介绍
zjiaoshou=教授
zjieshu=结束
zjiangsu=江苏
zjiasu=加速
zjieshi=解释
zjingsai=竞赛
zjianshi=坚实
zjuesai=决赛
zjiashi=驾驶
zjianshen=健身
zjishen=跻身
zjieshi=揭示
zjinsheng=晋升
zjiansuo=检索
zjiangshu=讲述
zjinsuo=紧缩
zjinshen=谨慎
zjianshi=监视
zjiesan=解散
zjiaoshe=交涉
zjishi=技师
zjieshi=结识
zjiansu=减速
zjisu=激素
zjingsui=精髓
zjianshou=坚守
zjiangshou=讲授
zjishou=棘手
zjishu=记述
zjisan=集散
zjinshi=近视
zjingshen=精深
zjianshi=见识
zjianshang=鉴赏
zjiangshi=将士
zjiasi=家私
zjushou=拒收
zjisu=急速
zjisui=脊髓
zjisi=缉私
zjianshu=简述
zjinshi=进食
zjixiu=寄宿
zjusang=沮丧
zjisi=祭祀
zjiaoshui=浇水
zjiashi=假释
zjisheng=寄生
zjianshang=奸商
zjiangshang=奖赏
zjueshi=爵士
zjuanshu=眷属
zjushou=聚首
zjiansun=减损
zjiasuo=枷锁
zjushu=拘束
zjiaosuo=教唆
zjiangshuai=将帅
zjueshi=绝食
zjishi=疾驶
zjiangsheng=缰绳
zjinshui=浸水
zjieshi=节食
zjianse=艰涩
zjianshi=检视
zjianshi=捡拾
zjiusi=酒肆
zjiesu=借宿
zjiangshi=僵尸
zjingsai=径赛
zjieshu=劫数
zjiansheng=俭省
zjiaoshe=嚼舌
zjiating=家庭
zjingtou=镜头
zjintie=津贴
zjingti=警惕
zjituo=寄托
zjietuo=解脱
zjingtai=静态
zjingti=晶体
zjingtong=精通
zjiantao=检讨
zjiaotang=教堂
zjianting=舰艇
zjianting=坚挺
zjieti=阶梯
zjiaotan=焦炭
zjintou=浸透
zjingtu=净土
zjiaotu=教徒
zjianta=践踏
zjutou=巨头
zjiantou=箭头
zjianti=简体
zjiantan=健谈
zjiaotong=绞痛
zjiantie=剪贴
zjitan=祭坛
zjianting=监听
zjiangtu=疆土
zjingtiao=荆条
zjiongtai=窘态
zjuntan=均摊
zjingtun=鲸吞
zjiaotu=焦土
zjiutu=酒徒
zjuewu=觉悟
zjingwei=经纬
zjiangwen=降温
zjiaowai=郊外
zjiewei=结尾
zjiuwang=救亡
zjinwo=紧握
zjiawen=加温
zjunwei=军威
zjingwei=敬畏
zjianwang=健忘
zjingwei=精微
zjianwu=奸污
zjiewen=诘问
zjiewei=解围
zjingwu=静物
zjiwo=鸡窝
zjuewei=爵位
zjiuwo=酒窝
zjixu=继续
zjingxin=精心
zjuxi=据悉
zjiexian=界限
zjianxin=艰辛
zjingxi=精细
zjiexiao=揭晓
zjingxiang=竞相
zjianxiao=见效
zjuxing=巨型
zjixiang=迹象
zjianxin=坚信
zjixu=积蓄
zjuanxian=捐献
zjianxun=简讯
zjianxi=间隙
zjingxi=惊喜
zjixiang=吉祥
zjixing=畸形
zjunxian=军衔
zjingxuan=竞选
zjuexing=觉醒
zjingxuan=精选
zjinxiu=锦绣
zjuxing=矩形
zjiaoxing=侥幸
zjixiao=技校
zjiuxu=就绪
zjianxing=碱性
zjingxing=惊醒
zjinxi=锦西
zjingxian=惊险
zjiaoxie=胶鞋
zjianxie=间歇
zjianxian=艰险
zjuxiang=巨响
zjingxian=敬献
zjuxing=巨星
zjiuxi=酒席
zjianxing=减刑
zjixi=即席
zjiuxin=揪心
zjunxiu=俊秀
zjixin=寄信
zjixiao=讥笑
zjiexu=接续
zjinxi=今昔
zjiaxin=加薪
zjixu=记叙
zjiaoxing=绞刑
zjinxiao=尽孝
zjiaoxiao=叫嚣
zjixing=极刑
zjiexin=戒心
zjiaoxia=狡黠
zjiaoxiao=娇小
zjianxing=饯行
zjixi=积习
zjuanxiu=娟秀
zjiaxin=夹心
zjiaoxie=缴械
zjunxiang=军饷
zjianxie=简写
zjianxi=奸细
zjiaxu=嘉许
zjiaoxiu=娇羞
zjianxiong=奸雄
zjiaoyu=教育
zjingyan=经验
zjianyi=建议
zjianyan=检验
zjueyi=决议
zjiya=积压
zjianyu=鉴于
zjianyu=监狱
zjianyi=检疫
zjinyin=金银
zjiangyou=酱油
zjingye=敬业
zjiyi=技艺
zjianyi=简易
zjingya=惊讶
zjingyi=敬意
zjiayu=驾驭
zjingying=精英
zjiuyuan=救援
zjunyi=军医
zjianyao=简要
zjieyu=节育
zjueyuan=绝缘
zjiyu=寄予
zjiayu=甲鱼
zjianyue=检阅
zjingying=晶莹
zjieyu=结余
zjiya=挤压
zjiayao=佳肴
zjiuyi=就医
zxiaoyan=校验
zjianying=坚硬
zjiangyan=讲演
zjingyi=惊异
zjingyang=敬仰
zjingyu=境遇
zjieyuan=结缘
zjiaoyi=交椅
zjieyan=戒烟
zjiaoyang=骄阳
zjiyue=激越
zjingyu=精于
zjiongyi=迥异
zjianyi=坚毅
zjieyu=节余
zjieyue=借阅
zjiaoyi=教益
zjiangying=僵硬
zjueyu=绝育
zjuanyong=隽永
zjuyi=拘役
zjianying=剪影
zjieyan=戒严
zjiayin=佳音
zjiya=羁押
zjingye=精液
zjiyuan=机缘
zjiangyu=疆域
zjingyang=景仰
zjiaoyou=郊游
zjingyan=精盐
zjiayan=家宴
zjiyang=激扬
zjuanyi=倦意
zjiyu=觊觎
zjianyin=奸淫
zjiyuan=积怨
zjiuyan=酒宴
zjiaoyan=娇艳
zjiyuan=妓院
zjingyu=鲸鱼
zjiaoye=郊野
zjiyu=寄寓
zjingyang=静养
zjunyi=俊逸
zjingyi=惊疑
zjiangye=奖掖
zjiayi=夹衣
zjianya=监押
zjiaoyue=校阅
zjieyuan=结怨
zjieyu=劫狱
zjingzheng=竞争
zjianzhu=建筑
zjiuzheng=纠正
zjiezhi=截至
zjuanzeng=捐赠
zjiezhu=借助
zjiezhi=截止
zjiazu=家族
zjiezou=节奏
zjianzhi=简直
zjuezhu=角逐
zjuanzi=捐资
zjingzeng=净增
zjiuzhu=救助
zjiangzhang=奖章
zjuzi=巨资
zjiaozhi=交织
zjingzhan=精湛
zjizhun=基准
zjingzhi=精制
zjiaza=夹杂
zjizhan=挤占
zjuanzhu=捐助
zjuzhen=矩阵
zjingzhong=警钟
zjueze=抉择
zjingzhi=精致
zjingzi=精子
zjiaozi=饺子
zjingzhi=静止
zjingzhi=净值
zjiezhi=戒指
zjizhan=激战
zjiazuo=佳作
zjianzai=健在
zjianzhi=监制
zjiangzhuang=奖状
zjingzi=镜子
zjizeng=激增
zjiuzhen=就诊
zjingzhou=荆州
zjingzhong=敬重
zjiuzhi=旧址
zjizhen=急诊
zjiaozheng=矫正
zjiaozhu=浇铸
zjizan=积攒
zjianzhi=剪纸
zjizhi=机智
zjuzhu=巨著
zjingzou=竞走
zjuzi=桔子
zjingzhuang=精装
zjianzhuang=健壮
zjiaozhu=浇筑
zjizao=急躁
zjuezheng=绝症
zjingzhui=颈椎
zjingzhi=径直
zjiezha=结扎
zjiezhai=借债
zjinzi=浸渍
zjuzhong=聚众
zjizhu=脊柱
zjinze=尽责
zjuzhao=剧照
zjizhao=吉兆
zjizu=祭祖
zjiaozhuo=焦灼
zjiaozhi=脚趾
zjiazi=甲子
zjingzuo=静坐
zjinzhang=进帐
zjizhui=脊椎
zjiuzao=酒糟
zjiaozhun=校准
zjianzhen=坚贞
zjianzhang=简章
zjuanzong=卷宗
zjiaozha=狡诈
zjiaozao=焦躁
zjingzhong=净重
zjiazi=夹子
zjiaozi=轿子
zjianzhuang=简装
zjuzi=橘子
zjuzhong=剧终
zjianzha=奸诈
zjianze=简则
zjiaozong=娇纵
zkuai=酷爱
zkuangao=狂傲
zkune=困厄
zkaien=开恩
zkaolv=考虑
zkunrao=困扰
zkeli=颗粒
zkangri=抗日
zkonglong=恐龙
zkunan=苦难
zkunlun=昆仑
zkulian=苦练
zkaolong=靠拢
zkunao=苦恼
zkuanrong=宽容
zkurong=库容
zkailang=开朗
zkangle=康乐
zkure=酷热
zkulong=窟窿
zkengren=坑人
zkuli=苦力
zkuilan=溃烂
zkaolu=烤炉
zkairan=慨然
zkulun=库仑
zkangli=伉俪
zkeran=溘然
zkuilei=傀儡
zkulou=骷髅
zkualan=跨栏
zkoulan=扣篮
zkaolao=犒劳
zkanluan=戡乱
zkongbu=恐怖
zkeben=课本
zkaobei=拷贝
zkaibo=开播
zkunbang=捆绑
zkuobu=阔步
zkuobie=阔别
zkeban=刻板
zkaobei=靠背
zkuabao=挎包
zkangbian=抗辩
zkebo=刻薄
zkuangbao=狂暴
zkuangbiao=狂飙
zkebiao=课表
zkangbao=抗暴
zkuibai=溃败
zkoubai=叩拜
zkaocha=考察
zkuangchan=矿产
zkecheng=课程
zkuaican=快餐
zkancheng=堪称
zkancha=勘察
zkuanchang=宽敞
zkance=勘测
zkunchong=昆虫
zkuangcang=矿藏
zkaocha=考查
zkaochang=考场
zkuangchao=狂潮
zkuochuo=阔绰
zkecang=客舱
zkuchu=苦楚
zkechuan=客串
zkucha=裤衩
zkuchu=苦处
zkuice=窥测
zkuanchuo=宽绰
zkucang=库藏
zkacha=喀嚓
zkaiduan=开端
zkuada=夸大
zkengdao=坑道
zkaoda=拷打
zkedu=刻度
zkuangdeng=矿灯
zkongdong=孔洞
zkedou=蝌蚪
zkaodian=靠垫
zkaoding=考订
zkudan=苦胆
zkedai=苛待
zkeda=磕打
zkaohe=考核
zkangfu=康复
zkanghong=抗洪
zkanghan=抗旱
zkafei=咖啡
zkunhuo=困惑
zkuifa=匮乏
zkangheng=抗衡
zkaihuang=开荒
zkanfa=砍伐
zkenghai=坑害
zkehua=刻画
zkuanghuan=狂欢
zkonghuang=恐慌
zkuanhou=宽厚
zkongfu=孔府
zkenhuang=垦荒
zkaifan=开饭
zkanhu=看护
zkonghe=恐吓
zkuihua=葵花
zkangfen=亢奋
zkuohao=括号
zkongfu=空腹
zkehuan=科幻
zkuhai=苦海
zkaohuo=烤火
zkuanfan=宽泛
zkaofen=考分
zkuangfei=狂吠
zkunfa=困乏
zkuanhong=宽宏
zkuohu=括弧
zkefan=客饭
zkonggu=控股
zkaogu=考古
zkuanggong=矿工
zkugan=苦干
zkonggao=控告
zkuguo=苦果
zkugong=苦功
zkaige=凯歌
zkugua=苦瓜
zkuanggong=旷工
zkongge=空格
zkaoguan=考官
zkugao=枯槁
zkegu=刻骨
zkeji=科技
zkunjing=困境
zkuangjia=框架
zkuangjing=矿井
zkuaijie=快捷
zkangju=抗拒
zkongju=恐惧
zkujie=枯竭
zkaojiu=考究
zkaijue=开掘
zkangji=抗击
zkongjie=空姐
zkuajiang=夸奖
zkejian=课间
zkuijiu=愧疚
zkuijian=窥见
zkangjian=康健
zkunjiong=困窘
zkunjuan=困倦
zkaoju=考据
zkujiao=裤脚
zkangjin=亢进
zkaojuan=考卷
zkaijia=铠甲
zkuijia=盔甲
zkujing=枯井
zkeku=刻苦
zkaikuo=开阔
zkanke=坎坷
zkuankuo=宽阔
zkuku=苦苦
zkaiken=开垦
zkeke=苛刻
zkangkai=慷慨
zkuangkuang=框框
zkunku=困苦
zkongkuang=空旷
zkaike=开课
zkuangke=旷课
zkuakou=夸口
zkongkuo=空阔
zkaimu=开幕
zkaimo=楷模
zkumen=苦闷
zkongmiao=孔庙
zkuming=苦命
zkemu=渴慕
zkaipi=开辟
zkongpa=恐怕
zkaoping=考评
zkengpian=坑骗
zkepeng=磕碰
zkuangpian=诓骗
zkuangqu=矿区
zkuangqie=况且
zkaiqi=开启
zkuangquan=矿泉
zkeqiu=渴求
zkongque=孔雀
zkaoqu=考取
zkenqie=恳切
zkengqiang=铿锵
zkenqiu=恳求
zkanqi=看齐
zkuqi=哭泣
zkenqing=恳请
zkeqiu=苛求
zkaiqiao=开窍
zkuoqi=阔气
zkaoqin=考勤
zkuqiong=哭穷
zkengqi=吭气
zkaiqiang=开腔
zkuaisu=快速
zkuangshan=矿山
zkaoshi=考试
zkuosan=扩散
zkuansong=宽松
zkuangshi=矿石
zkushu=酷暑
zkaosheng=考生
zkeshou=恪守
zkuse=苦涩
zkaisai=开赛
zkeshi=课时
zkangshui=抗税
zkongsu=控诉
zkusi=酷似
zkesou=咳嗽
zkushui=苦水
zkeshui=课税
zkengsheng=吭声
zkuishi=窥视
zkuanshu=宽恕
zkeshui=瞌睡
zkuangshi=旷世
zkuishou=魁首
zkuise=愧色
zkuisan=溃散
zkaoshang=犒赏
zkushou=枯瘦
zkoushou=叩首
zkuisi=窥伺
zketi=课题
zkantan=勘探
zketang=课堂
zkaiting=开庭
zkangti=抗体
zkutou=苦头
zkaitan=慨叹
zkentan=恳谈
zkuatai=垮台
zkangtou=炕头
zketou=磕头
zkuaiting=快艇
zkaituo=开脱
zkuangtu=框图
zkutui=裤腿
zkaoti=考题
zkoutou=叩头
zkuitan=喟叹
zkuitan=窥探
zkantou=看透
zkuitui=溃退
zkewang=渴望
zkuangwu=矿物
zkewai=课外
zkuwei=枯萎
zkuiwu=魁梧
zkewen=课文
zkuanwei=宽慰
zkuaiwei=快慰
zkuangwang=狂妄
zkuiwei=魁伟
zkaowen=拷问
zkanwu=勘误
zkongxi=空袭
zkuxin=苦心
zkangxi=康熙
zkaixuan=凯旋
zkongxi=空隙
zkongxian=空闲
zkongxu=空虚
zkuxiao=苦笑
zkuxue=苦学
zkaoxiang=烤箱
zkuxing=酷刑
zkuangxi=狂喜
zkouxie=叩谢
zkeyan=科研
zkaoyan=考验
zkuangye=矿业
zkangyi=抗议
zkaoyan=烤烟
zkuyu=苦于
zkangyu=抗御
zkeyi=刻意
zkaoya=烤鸭
zkuiyang=溃疡
zkuanyu=宽裕
zkeyu=课余
zkuangye=旷野
zkuyi=苦役
zkeyin=刻印
zkuyao=裤腰
zkuayao=夸耀
zkaiyou=揩油
zkuangyu=诳语
zkongzhi=控制
zkangzhan=抗战
zkongzi=孔子
zkangzai=抗灾
zkuazhang=夸张
zkaozheng=考证
zkuizeng=馈赠
zkangzheng=抗争
zkuzao=枯燥
zkuzhan=苦战
zkangzhen=抗震
zkuzi=裤子
zkuaizi=筷子
zkuzhong=苦衷
zkezhuo=课桌
zkaizao=开凿
zkuaizhuang=块状
zkunza=捆扎
zkenzhi=垦殖
zkouzhao=口罩
zkuazan=夸赞
zkezi=刻字
zkezhan=客栈
zkuanzhai=宽窄
zkuangzheng=匡正
zkeze=苛责
zkunzhong=昆仲
zkezi=壳子
zkezheng=苛政
zkanzheng=勘正
zmaan=马鞍
zmuai=母爱
zmianao=棉袄
zmoai=默哀
zmuai=暮霭
zmoer=摩尔
zmianlin=面临
zmoni=模拟
zmeili=美丽
zmeili=魅力
zmeirong=美容
zmingliang=明亮
zminrui=敏锐
zmanglu=忙碌
zmulin=睦邻
zmianli=勉励
zmangren=盲人
zmaoli=毛利
zmonan=磨难
zmuru=母乳
zmenglie=猛烈
zmenglong=朦胧
zminglang=明朗
zmolian=磨练
zmangran=茫然
zmianrong=面容
zmoulve=谋略
zmilian=迷恋
zmenre=闷热
zmunv=母女
zmailuo=脉络
zmoli=磨砺
zmanao=玛瑙
zmaolv=毛驴
zmoli=茉莉
zmaoniu=牦牛
zmilin=密林
zmenling=门铃
zmuli=牡蛎
zmoran=蓦然
zmiliu=弥留
zmolv=墨绿
zmaoling=冒领
zmaoliao=毛料
zmoran=默然
zmunian=暮年
zmoren=默认
zmiulun=谬论
zmoran=漠然
zmali=麻利
zmeilu=煤炉
zmiaoling=妙龄
zmeilan=霉烂
zmengnan=蒙难
zmuren=牧人
zmenlian=门帘
zmili=米粒
zmilan=糜烂
zmailang=麦浪
zmaolu=茅庐
zmoni=摹拟
zmiling=密令
zmuliao=幕僚
zmolu=陌路
zmenglang=孟浪
zmuou=木偶
zmubiao=目标
zmibu=弥补
zminbing=民兵
zmaobing=毛病
zmanbu=漫步
zmuban=木板
zmabi=麻痹
zmaibo=脉搏
zmuban=模板
zmaobi=毛笔
zmibu=密布
zmianbu=棉布
zmaibu=迈步
zmibi=密闭
zmubei=墓碑
zmeibian=霉变
zmubang=木棒
zmabu=麻布
zmianbi=面壁
zmubu=幕布
zmobai=膜拜
zmuben=母本
zmengbi=蒙蔽
zmibao=密报
zmobi=墨笔
zmucai=木材
zmanchang=漫长
zmoca=摩擦
zmenchuang=门窗
zmaichong=脉冲
zmuchang=牧场
zmaicang=埋藏
zmianchu=免除
zmaochong=冒充
zmucao=牧草
zmoca=磨擦
zmaocao=茅草
zmangcong=盲从
zmuchun=暮春
zmuce=目测
zmengchun=孟春
zmuchai=木柴
zmingcha=明察
zmiaochu=妙处
zmeichao=美钞
zmengchen=蒙尘
zmoceng=磨蹭
zmangchang=盲肠
zmaocao=毛糙
zmaodun=矛盾
zmudan=牡丹
zmidu=密度
zmiandian=缅甸
zmudu=目睹
zmadai=麻袋
zmudi=墓地
zmodi=摸底
zmudiao=木雕
zmoduan=末端
zmiande=免得
zmidi=谜底
zmaoding=铆钉
zmodeng=摩登
zmengdong=萌动
zmode=蓦地
zmodao=磨刀
zmangdian=盲点
zmidian=密电
zmeidu=梅毒
zmangda=盲打
zminhang=民航
zmofan=模范
zmianfei=免费
zmafan=麻烦
zmohu=模糊
zmifeng=密封
zmaofang=毛纺
zmiaohui=描绘
zmanhua=漫画
zmeifeng=每逢
zmeihua=梅花
zmofang=模仿
zmiehuo=灭火
zmengfa=萌发
zmianhuai=缅怀
zmenghuan=梦幻
zmiaohui=庙会
zmihuo=迷惑
zmifeng=蜜蜂
zmifan=米饭
zmouhua=谋划
zmuhou=幕后
zmafeng=麻风
zmohe=磨合
zmaofa=毛发
zmaifu=埋伏
zmanheng=蛮横
zmanfu=满腹
zmofang=磨坊
zmohei=摸黑
zmihe=弥合
zmahua=麻花
zmeihao=煤耗
zmihu=迷糊
zmafei=吗啡
zmeifu=妹夫
zmingfang=鸣放
zmanhuang=蛮荒
zmaohuo=冒火
zminfen=民愤
zmingfan=明矾
zmiaofang=妙方
zmifeng=眯缝
zmenfeng=门缝
zmaofang=茅房
zmouhai=谋害
zmaofan=冒犯
zmaohao=冒号
zmenghun=蒙混
zmoufan=谋反
zmohe=墨盒
zmahuang=蚂蟥
zmenggu=蒙古
zmingan=敏感
zmangu=曼谷
zminggui=名贵
zmangguo=芒果
zmeigui=玫瑰
zmogu=蘑菇
zmugun=木棍
zmangan=蛮干
zmagua=马褂
zmoguang=磨光
zmuge=牧歌
zmigao=密告
zmianji=面积
zmaijin=迈进
zmiji=密集
zmuji=募集
zmujuan=募捐
zmaojin=毛巾
zmiejue=灭绝
zminjie=敏捷
zmijue=秘诀
zmajiang=麻将
zmingji=铭记
zmianjian=免检
zmaojian=冒尖
zmuji=母鸡
zmoji=墨迹
zmengjing=梦境
zmingjing=明镜
zmaojin=冒进
zmojing=墨镜
zmijian=蜜饯
zmingjiao=鸣叫
zmingjing=明净
zmajia=马甲
zmianjia=面颊
zmaju=马驹
zmiaoji=妙计
zmojia=墨家
zmieji=灭迹
zmiji=秘籍
zmijian=密件
zmenjiu=闷酒
zmeikuang=煤矿
zmokuai=模块
zmiankong=面孔
zmenkan=门槛
zmuke=木刻
zmingke=铭刻
zmaokong=毛孔
zmianku=棉裤
zmenkuang=门框
zmoku=魔窟
zmaoku=毛裤
zmaokeng=茅坑
zmiekou=灭口
zmianmao=面貌
zmangmu=盲目
zmimi=秘密
zmumin=牧民
zmomo=默默
zmuming=慕名
zmingma=明码
zmeimei=妹妹
zmangmang=茫茫
zmima=密码
zmingmai=命脉
zmiman=弥漫
zmeimiao=美妙
zmanman=漫漫
zmamu=麻木
zmaomi=茂密
zmingmei=明媚
zmaimei=埋没
zmeimao=眉毛
zmimang=迷茫
zmangmang=莽莽
zminmie=泯灭
zmengmeng=蒙蒙
zmiaomang=渺茫
zmanma=谩骂
zmomie=磨灭
zmeimao=美貌
zmimou=密谋
zmaimiao=麦苗
zmengmei=蒙昧
zmenmei=门楣
zmiaomo=描摹
zmaomei=冒昧
zmiman=迷漫
zmaoming=冒名
zmami=妈咪
zmanmiao=曼妙
zmimian=谜面
zmiemen=灭门
zmaopi=毛皮
zmiaopu=苗圃
zmaopai=冒牌
zmengpian=蒙骗
zmianpang=面庞
zmapi=马匹
zmaopi=毛坯
zmopan=磨盘
zmaopeng=茅棚
zmeipu=没谱
zmeipo=媒婆
zmaipian=麦片
zmianpiao=免票
zmapi=马屁
zmingque=明确
zmiqie=密切
zmuqin=母亲
zmuqu=牧区
zmouqiu=谋求
zmoqing=摸清
zmianqiang=勉强
zmouqu=谋取
zmoqi=默契
zmanqiang=满腔
zmaque=麻雀
zmingqiang=鸣枪
zmenqi=闷气
zmengqin=猛禽
zmoshi=模式
zmiaoshu=描述
zminsu=民俗
zmianshui=免税
zmosuo=摸索
zmosheng=陌生
zmosun=磨损
zmeishi=美食
zmengshou=蒙受
zmousheng=谋生
zmousi=谋私
zmengsheng=萌生
zmaosheng=茂盛
zmaishou=麦收
zmousha=谋杀
zmushi=牧师
zmianshi=面试
zmoshi=漠视
zmoshui=墨水
zmaosi=貌似
zmieshi=蔑视
zmeishao=眉梢
zmaishe=埋设
zmuse=暮色
zmianshi=免试
zmiaoshi=藐视
zmaisui=麦穗
zmishi=觅食
zmianshou=面授
zmasheng=麻绳
zmengshou=猛兽
zmoushi=谋士
zmisa=弥撒
zmishi=密室
zmangshe=蟒蛇
zmengshi=猛士
zmaoshi=冒失
zmeitan=煤炭
zmatou=码头
zmotuo=摩托
zmaotai=茅台
zmote=模特
zmantou=馒头
zmuti=母体
zmantian=漫天
zmiaotou=苗头
zmaotan=毛毯
zmaitou=埋头
zmatong=马桶
zmenting=门庭
zmati=马蹄
zmingtang=名堂
zmiaotiao=苗条
zmiantian=腼腆
zmutan=木炭
zmaotou=矛头
zmantan=漫谈
zmitang=米汤
zmutong=牧童
zmotian=摩天
zmituan=谜团
zmiaotu=描图
zmentu=门徒
zmitan=密谈
zmitan=密探
zmeiwei=美味
zmiewang=灭亡
zmiwang=迷惘
zmiwu=迷雾
zmaowu=茅屋
zmiuwu=谬误
zmowei=末尾
zmingwen=铭文
zmangwen=盲文
zmeiwai=媚外
zmoxing=模型
zmingxi=明晰
zmiaoxie=描写
zmaoxian=冒险
zmuxiao=母校
zmaoxian=毛线
zmuxiang=木箱
zmuxue=墓穴
zmiaoxiao=渺小
zmianxu=棉絮
zmuxi=母系
zmengxing=猛醒
zmianxie=棉鞋
zmoxu=默许
zmuxie=木屑
zmuxuan=目眩
zmuxing=母性
zmingxiang=冥想
zmoxie=默写
zmingxie=鸣谢
zmianxing=免刑
zmoxi=末席
zmaixiang=脉象
zmingyu=名誉
zmanyan=蔓延
zmianyi=免疫
zmaiyin=卖淫
zmuyang=模样
zmayi=蚂蚁
zmingyi=名医
zmengya=萌芽
zmeiyu=美誉
zmaoyi=毛衣
zmaoyu=冒雨
zmuyu=沐浴
zmanyuan=埋怨
zmianyan=绵延
zmianyang=绵羊
zminyao=民谣
zmianyi=面议
zmanyou=漫游
zmayou=麻油
zmeiyu=美育
zmiaoyu=庙宇
zmiyue=蜜月
zmeiyu=梅雨
zmeiyu=眉宇
zmuyuan=墓园
zmiaoyong=妙用
zmiaoyu=妙语
zmiyu=谜语
zmaiyi=卖艺
zmuyu=母语
zmengyi=梦呓
zmangyuan=莽原
zmayao=麻药
zmiyou=密友
zmeiyan=美艳
zmengyou=梦游
zmengyan=梦魇
zmiyue=密约
zmoya=磨牙
zmaoyan=帽檐
zmingyuan=鸣冤
zmeiyan=媚眼
zminyuan=民怨
zmingyu=明喻
zminzu=民族
zmiaozhun=瞄准
zmaozi=帽子
zmenzhen=门诊
zminzhong=民众
zmeizhou=美洲
zmianzheng=免征
zmingzhi=明智
zmanzu=满族
zmiaozu=苗族
zmuzi=母子
zmazui=麻醉
zmianzhi=免职
zmuzhi=拇指
zmouzhi=谋职
zmeizi=妹子
zmuzang=墓葬
zmaizi=麦子
zmiaozi=苗子
zmaizang=埋葬
zmengzi=孟子
zmazi=麻子
zmuzhuang=木桩
zmengzu=蒙族
zmazhen=麻疹
zmouzi=眸子
zmozhao=魔爪
zmeizhe=没辙
zmianzhao=面罩
zmazong=马鬃
zmazha=蚂蚱
zmozhi=墨汁
zmangzhuang=莽撞
zmangzhong=芒种
zmiezhong=灭种
zmozhang=魔障
zmaozei=毛贼
zmiezu=灭族
zmaozao=毛躁
zpanan=判案
zpeie=配额
zpiaoliang=漂亮
zpinlv=频率
zpilu=披露
zpiruan=疲软
zpilao=疲劳
zpilin=毗邻
zpengren=烹饪
zpinren=聘任
zpolie=破裂
zpiru=譬如
zpingrang=平壤
zpoli=魄力
zpeiliao=配料
zpolan=破烂
zpenglai=蓬莱
zpoli=破例
zpulu=铺路
zpailao=排涝
zpianren=骗人
zpiaoliu=漂流
zpangren=旁人
zpola=泼辣
zpirou=皮肉
zpilian=毗连
zpanluan=叛乱
zpiaoluo=飘落
zpili=霹雳
zpiaoran=飘然
zpuren=仆人
zpailei=排雷
zpinruo=贫弱
zpinnong=贫农
zpilou=纰漏
zpanni=叛逆
zpianran=翩然
zpailuan=排卵
zpiaoling=飘零
zpanrao=盘绕
zpeili=赔礼
zpengluan=蓬乱
zponiang=婆娘
zpinli=聘礼
zpilei=疲累
zpoluo=笸箩
zpianlao=偏劳
zpanli=叛离
zpeiou=配偶
zpubian=普遍
zpengbo=蓬勃
zpeibei=配备
zpinbo=拼搏
zpangbian=旁边
zpingban=平板
zpaiban=拍板
zpanbi=攀比
zpubu=瀑布
zpaobing=炮兵
zpibei=疲惫
zpeiban=陪伴
zpaibian=牌匾
zpeiben=赔本
zpingbi=屏蔽
zpanbie=判别
zpaibing=派兵
zpiaobo=漂泊
zpubi=扑鼻
zpangbo=磅礴
zpiaobai=漂白
zpanbao=盘剥
zpibo=批驳
zpengbi=碰壁
zpanbian=叛变
zpobai=破败
zpingba=坪坝
zpengbei=碰杯
zpangbai=旁白
zpeichang=赔偿
zpanchu=判处
zpaichi=排斥
zpinchang=品尝
zpinchuan=频传
zpincou=拼凑
zpingchuan=平川
zpingce=评测
zpaocai=泡菜
zpengchang=捧场
zpeichen=陪衬
zpanchan=盘缠
zpianchou=片酬
zpiaochong=瓢虫
zpuchi=扑哧
zpanduan=判断
zpangda=庞大
zpendi=盆地
zpinde=品德
zpandeng=攀登
zpindao=频道
zpanding=判定
zpaodan=炮弹
zpeidian=配电
zpeidai=佩带
zpeidai=佩戴
zpudian=铺垫
zpeidui=配对
zpiaodang=飘荡
zpidi=匹敌
zpidan=皮蛋
zpiaodong=飘动
zpiaodai=飘带
zpengda=膨大
zpindu=频度
zpandang=叛党
zpeihe=配合
zpingheng=平衡
zpinfan=频繁
zpifu=皮肤
zpeifang=配方
zpaihuai=徘徊
zpinfu=贫富
zpinfa=贫乏
zpohai=迫害
zpeifu=佩服
zpinghuan=平缓
zpenfa=喷发
zpeifa=配发
zpiaofu=漂浮
zpinhan=贫寒
zpaifang=牌坊
zpanghuang=彷徨
zpinghua=平滑
zpifa=疲乏
zpingfeng=屏风
zpiaofu=飘浮
zpihuo=皮货
zpianfei=偏废
zpiaohu=飘忽
zpufu=匍匐
zpaofan=泡饭
zpengfu=捧腹
zpoufu=剖腹
zpihao=癖好
zpanhuan=盘桓
zpifu=匹夫
zpiaohan=剽悍
zpanfu=攀附
zpiaofu=飘拂
zpinfu=姘妇
zpofu=泼妇
zpanhuo=盘货
zpianfeng=偏锋
zpinfu=姘夫
zpingguo=苹果
zpinge=品格
zpoge=破格
zpigu=屁股
zpenguan=喷灌
zpaoguang=抛光
zpangguang=膀胱
zpugai=铺盖
zpigua=披挂
zpangguan=旁观
zpanguo=叛国
zpanguan=判官
zpangen=盘亘
zpenggen=捧哏
zpijiu=啤酒
zpeijian=配件
zpanjue=判决
zpingjing=平静
zpingjie=凭借
zpingjing=瓶颈
zpinji=贫瘠
zpenjing=盆景
zpijuan=疲倦
zpengji=抨击
zpianju=骗局
zpeijiao=配角
zpojia=婆家
zpaiji=排挤
zpeiji=配给
zpinji=品级
zpijing=僻静
zpojin=迫近
zpianji=偏激
zpingju=凭据
zpengjian=碰见
zpijian=披肩
zpanju=盘踞
zpinjian=贫贱
zpojiang=迫降
zpengjia=棚架
zpiejian=瞥见
zpanjun=叛军
zpenjian=喷溅
zpinju=姘居
zpanjie=盘诘
zpojie=破戒
zpinkun=贫困
zpeikuan=赔款
zpianke=片刻
zpinku=贫苦
zpingkong=凭空
zpiekai=撇开
zpiaoke=嫖客
zpoukai=剖开
zpingmu=屏幕
zpaomo=泡沫
zpinming=拼命
zpimei=媲美
zpimao=皮毛
zpoumian=剖面
zpumie=扑灭
zpomie=破灭
zpomo=泼墨
zpumian=铺面
zpaomao=抛锚
zpinmin=贫民
zpanming=判明
zpiaomiao=缥缈
zpenmo=喷墨
zpengmian=碰面
zpinmao=品貌
zpipan=批判
zpinpin=频频
zpianpi=偏僻
zpopo=婆婆
zpipei=匹配
zpingpan=评判
zpipa=琵琶
zpuping=铺平
zpingpang=乒乓
zpapo=爬坡
zpipa=枇杷
zpengpai=澎湃
zpianpian=翩翩
zpinping=品评
zpinpan=拼盘
zpianpang=偏旁
zpengpeng=怦怦
zpoqie=迫切
zpinqing=聘请
zpinqiong=贫穷
zpaoqi=抛弃
zpaiqian=派遣
zpianqu=骗取
zpenqi=喷气
zpeiqian=赔钱
zpiqi=脾气
zpenquan=喷泉
zpenqi=喷漆
zpanqin=攀亲
zpiaoqie=剽窃
zbaqie=扒窃
zpengqiao=碰巧
zpaiqian=排遣
zpuqu=谱曲
zpianqiao=偏巧
zposhi=迫使
zpushi=朴实
zpushe=铺设
zpusu=朴素
zposui=破碎
zpansheng=攀升
zposun=破损
zpingshu=评述
zpaoshou=抛售
zpanshan=蹒跚
zpusa=菩萨
zpensa=喷洒
zpenshe=喷射
zpashan=爬山
zpinshu=聘书
zpashou=扒手
zpingsu=平素
zposuo=婆娑
zpianshu=骗术
zpinsi=拼死
zpingshi=平视
zpianshi=偏食
zpengsong=蓬松
zpiaosa=飘洒
zpiaosan=飘散
zpushai=曝晒
zpeise=配色
zpishuang=砒霜
zpushan=蒲扇
zpiaoshi=飘逝
zpeishi=陪侍
zpeitao=配套
zputao=葡萄
zpengtiao=烹调
zpingtan=平坦
zpeitai=胚胎
zpangting=旁听
zpingtian=平添
zpentu=喷涂
zpantu=叛徒
zpantan=攀谈
zpingtan=乒坛
zpentou=喷头
zpiantan=偏瘫
zpiantan=偏袒
zpengtou=碰头
zpangtuo=滂沱
zpantao=叛逃
zputi=菩提
zpaotang=泡汤
zputeng=扑腾
zpingdan=评弹
zpenti=喷嚏
zpaotui=跑腿
zpantou=盼头
zpantao=蟠桃
zpantui=盘腿
zpingting=娉婷
zpintou=姘头
zpingwen=平稳
zpaiwu=排污
zpinwei=品位
zpanwang=盼望
zpinwei=品味
zpuwei=铺位
zpiwei=脾胃
zpiaowu=飘舞
zpeixun=培训
zpixie=皮鞋
zpuxie=谱写
zpouxi=剖析
zpingxi=平息
zpanxing=判刑
zpangxie=螃蟹
zpinxue=贫血
zpaixie=排泄
zpanxuan=盘旋
zpaxing=爬行
zpinxing=品行
zpaoxiao=咆哮
zpoxi=婆媳
zpixiang=皮箱
zpinxing=品性
zpiexia=撇下
zpinxie=拼写
zpianxian=翩跹
zpuxi=谱系
zpixue=皮靴
zpoxiao=破晓
zpiaoxiang=票箱
zpixing=脾性
zpeixi=配戏
zpaxiu=怕羞
zpeixiao=赔笑
zpanxi=盘膝
zpeiyang=培养
zpeiyu=培育
zpianyi=便宜
zpingyi=评议
zpinyong=聘用
zpiaoyang=飘扬
zpaiyan=排演
zpiaoyi=飘逸
zpingyong=平庸
zpianyi=偏移
zpoyi=破译
zpaoying=泡影
zpinyin=拼音
zpiaoyi=漂移
zpiyue=批阅
zpingyi=平移
zpeiyao=配药
zpeiyin=配音
zpeile=配乐
zpiaoyao=飘摇
zpanyue=攀越
zpanyan=攀岩
zpiyao=辟谣
zpuyi=仆役
zpiyu=譬喻
zpingyue=评阅
zpinyue=聘约
zpizhun=批准
zpinzhong=品种
zpeizhi=配置
zpinzhi=品质
zpingzheng=凭证
zpengzhang=膨胀
zpianzhang=篇章
zpengzhuang=碰撞
zpeizhi=培植
zpeizhi=配制
zpingzheng=平整
zpaizhao=牌照
zpingzhang=屏障
zpaizhao=拍照
zpianzi=骗子
zpingzhuang=瓶装
zpingzi=瓶子
zpenzai=盆栽
zpangzi=胖子
zpengzi=棚子
zpuzhao=普照
zpangza=庞杂
zpeizang=陪葬
zpuzhang=铺张
zpuzi=铺子
zpizi=痞子
zpozhan=破绽
zpianzhi=偏执
zpangzheng=旁证
zpaozhi=抛掷
zpeizui=赔罪
zpizhen=皮疹
zpingze=平仄
zpanzui=判罪
zpanshe=攀折
zpaozhang=炮仗
zpinzui=贫嘴
zqiean=窃案
zqie=企鹅
zqianglie=强烈
zqianli=潜力
zqueli=确立
zqueren=确认
zqiaoliang=桥梁
zqinglai=青睐
zqinlve=侵略
zqinlao=勤劳
zqiuling=丘陵
zqianneng=潜能
zqinlin=亲临
zqianlong=乾隆
zqinna=擒拿
zqianru=迁入
zqinling=秦岭
zqunuan=取暖
zqinru=侵入
zqingliang=清凉
zquannei=圈内
zqiongren=穷人
zqinglv=情侣
zquru=屈辱
zqianru=潜入
zqinei=气馁
zqiliang=凄凉
zqinglian=清廉
zqianlian=牵连
zqiling=欺凌
zqilin=麒麟
zqiaoli=俏丽
zqingli=清丽
zqinglang=晴朗
zqingliang=清亮
zqili=绮丽
zqianrang=谦让
zqinrao=侵扰
zqinni=亲昵
zqianliu=潜流
zqienuo=怯懦
zqilu=歧路
zqinglang=清朗
zqili=凄厉
zqiran=凄然
zqianli=前例
zqianlei=牵累
zqiannu=迁怒
zqinglang=情郎
zqieruo=怯弱
zqilian=乞怜
zqiuou=求偶
zqunou=群殴
zquebao=确保
zqiangbi=墙壁
zqianbei=前辈
zqianbi=铅笔
zqiaobao=侨胞
zqibei=齐备
zqibing=骑兵
zqianbi=钱币
zqingbo=轻薄
zqiaobi=峭壁
zqiangbi=枪毙
zqianbao=浅薄
zqiangbao=襁褓
zqiangbao=墙报
zqiangbao=强暴
zqiubo=秋波
zqibing=奇兵
zquanbing=权柄
zqibing=起兵
zqiangbi=强逼
zqianbei=谦卑
zqiaoba=峭拔
zqiche=汽车
zqingchu=清楚
zqicai=器材
zquche=驱车
zqingcao=情操
zquancheng=全程
zqiancheng=前程
zqicheng=启程
zqingche=清澈
zqiancheng=虔诚
zqiecuo=切磋
zqucai=取材
zqincai=芹菜
zqingcui=清脆
zqingcang=清仓
zqianche=牵扯
zqiaocui=憔悴
zqingchun=清纯
zqingcui=青翠
zqingcha=清茶
zqiancang=潜藏
zqican=凄惨
zqichuan=气喘
zqicheng=起程
zqichang=齐唱
zquchu=驱除
zqichi=启齿
zqucong=屈从
zquchi=曲尺
zqichu=凄楚
zqinchao=秦朝
zqiuche=囚车
zqincha=钦差
zqiaochu=翘楚
zqiechang=怯场
zqichuang=气窗
zqucai=屈才
zquanchi=犬齿
zqianci=谦辞
zquce=驱策
zqueding=确定
zqudao=渠道
zqianding=签订
zqidong=启动
zqudong=驱动
zqudi=取缔
zqiandong=牵动
zqidi=启迪
zqingdian=庆典
zqiadang=恰当
zqingdao=倾倒
zqidao=祈祷
zqiaoda=敲打
zqiaodun=桥墩
zqiangduo=抢夺
zqidi=汽笛
zqiangdao=强盗
zqingdan=氢弹
zqidai=脐带
zqidan=契丹
zqiangdan=枪弹
zqiandao=签到
zqiangdiao=腔调
zquandian=圈点
zqiandan=浅淡
zqingdun=清炖
zqinduo=侵夺
zquefa=缺乏
zqihuo=期货
zqihou=气候
zqifen=气氛
zqinfan=侵犯
zqinhai=侵害
zqifa=启发
zqinfen=勤奋
zqifu=起伏
zqianfa=签发
zqiahao=恰好
zqianfan=遣返
zqifen=气愤
zqinghe=庆贺
zqufu=屈服
zqihao=旗号
zqianhai=浅海
zqianfu=潜伏
zqiafeng=恰逢
zqianfeng=前锋
zquanheng=权衡
zqiaohe=巧合
zquehan=缺憾
zqihei=漆黑
zqifeng=奇峰
zqiufan=囚犯
zqifu=欺负
zqihe=契合
zqiaohui=侨汇
zquehuo=缺货
zqianhe=谦和
zqiaohuo=俏货
zqianfu=纤夫
zqihang=启航
zqihong=起哄
zqingfu=倾覆
zqianghan=强悍
zqihua=汽化
zqingfu=清福
zqifeng=启封
zqingfu=轻浮
zqianghai=戕害
zqiuhe=丘壑
zquanfu=蜷伏
zqiangheng=强横
zqianhao=堑壕
zqifeng=骑缝
zqufu=趋附
zqianggou=抢购
zqigai=乞丐
zqigai=气概
zqiangua=牵挂
zqiongguo=穷国
zqiguan=企管
zquangao=劝告
zqigan=旗杆
zqugan=驱赶
zqigang=汽缸
zqiangong=谦恭
zqugan=躯干
zquangui=权贵
zqionggui=穷鬼
zqiji=奇迹
zqiangjiu=抢救
zqiji=契机
zqingjie=清洁
zqijin=迄今
zqiangjie=抢劫
zqinjian=勤俭
zqiaojuan=侨眷
zqiangjian=强奸
zqianjiu=迁就
zqieji=切忌
zqianjia=欠佳
zqiangjiao=墙角
zqianju=迁居
zqiaoju=侨居
zqingjian=请柬
zqiangjian=强健
zqiaoji=敲击
zqingjing=清静
zqingjing=清净
zqiujin=遒劲
zqiujin=囚禁
zqiangjiao=墙脚
zqiji=企及
zqianjiu=歉疚
zqiuji=球技
zqinjing=钦敬
zqiongjin=穷尽
zqingjie=轻捷
zqianjian=浅见
zqiju=栖居
zqujiu=屈就
zqiaojin=巧劲
zqianjin=浅近
zqiaoji=巧计
zqianjing=虔敬
zqingjin=青筋
zqinjuan=亲眷
zqingkuang=情况
zqingke=顷刻
zqingku=清苦
zqiankun=乾坤
zqiongkun=穷困
zqingke=青稞
zqikong=气孔
zqiongku=穷苦
zqinken=勤恳
zquqiao=躯壳
zqinkuai=勤快
zqiake=卡壳
zqima=起码
zqianming=签名
zqiaomiao=巧妙
zqiaomu=乔木
zqimeng=启蒙
zqinmi=亲密
zqimiao=奇妙
zqimin=器皿
zqima=骑马
zqiaomin=侨民
zquanmao=全貌
zqiaomai=荞麦
zqiming=齐名
zqiaomen=窍门
zqinmian=勤勉
zqianmo=阡陌
zqingmie=轻蔑
zquanmou=权谋
zqingmu=倾慕
zqinmu=钦慕
zqimou=奇谋
zqiman=欺瞒
zqimen=气闷
zqipian=欺骗
zqiangpo=强迫
zqipo=气魄
zqinpei=钦佩
zqipan=企盼
zqipan=期盼
zqingpin=清贫
zqipa=奇葩
zqipao=气泡
zqipao=旗袍
zqingpen=倾盆
zqiaopi=俏皮
zqupu=曲谱
zqipao=起泡
zqipu=棋谱
zqiepan=切盼
zqiquan=齐全
zqinquan=侵权
zqiaqia=恰恰
zqinqi=亲戚
zqingqu=情趣
zqueqie=确切
zqiqu=崎岖
zqingquan=清泉
zqingqi=轻骑
zqiaoqian=乔迁
zqiequ=窃取
zqiquan=弃权
zqianqiu=铅球
zqiaqiao=恰巧
zqingqiao=轻巧
zqiqiu=乞求
zqiqiu=祈求
zqinqiang=秦腔
zqiqiao=蹊跷
zqiqiu=企求
zqueqiao=鹊桥
zqiqiao=奇巧
zqianqu=前驱
zqianqiang=牵强
zqueqin=缺勤
zqiqing=凄清
zquqiao=取巧
zquanqin=全勤
zquanqu=蜷曲
zquqian=驱遣
zquqi=取齐
zqiangqin=抢亲
zqushi=趋势
zqueshi=确实
zqianshu=签署
zqishi=启示
zqingsong=轻松
zqinshi=侵蚀
zqishi=歧视
zqushi=驱使
zqiangshou=抢手
zqishi=启事
zqingshi=轻视
zqianshe=牵涉
zqiusuo=求索
zqianshui=潜水
zqingsu=倾诉
zqiangsheng=强盛
zquanshui=泉水
zqishui=汽水
zqiaoshou=翘首
zqingsong=青松
zqushe=取舍
zqingshuang=清爽
zquanshi=诠释
zqiasi=恰似
zqishen=栖身
zqiansong=遣送
zquesun=缺损
zqusan=驱散
zqianse=浅色
zqisheng=齐声
zqiusai=球赛
zqiansan=遣散
zqushi=趣事
zqingshou=清瘦
zqishou=旗手
zqinshi=寝室
zqinshu=亲疏
zqiaoshou=巧手
zquansuo=蜷缩
zquansu=全速
zqianshou=签收
zquansheng=全盛
zqisai=棋赛
zqinshou=禽兽
zqisheng=气盛
zqinse=琴瑟
zqiongsuan=穷酸
zqisheng=欺生
zqishi=起誓
zqiantu=前途
zqiatan=洽谈
zqitu=企图
zqiantou=牵头
zqingting=倾听
zqingtong=青铜
zqintun=侵吞
zqianting=潜艇
zqingtang=清汤
zquti=躯体
zqitao=乞讨
zqiantao=潜逃
zqutong=趋同
zqitu=歧途
zqingtu=倾吐
zqingting=蜻蜓
zquantao=圈套
zqiantan=浅滩
zqingtai=情态
zqieting=窃听
zqiting=汽艇
zqingtai=青苔
zqingtie=请帖
zqingtiao=轻佻
zqitai=气态
zquanwei=权威
zqiwen=气温
zquwei=趣味
zqiaowu=侨务
zqiwei=气味
zqinwu=勤务
zqingwa=青蛙
zqiwu=起舞
zqiwang=企望
zquanwei=劝慰
zqiwu=欺侮
zquwen=趣闻
zqiangwei=蔷薇
zqiwan=凄婉
zquanxian=全县
zquxiao=取消
zqingxiao=倾销
zqingxie=倾斜
zqingxu=情绪
zqingxiang=倾向
zqingxi=清晰
zqingxing=清醒
zqianxi=前夕
zquxian=区县
zquxiang=趋向
zqingxing=情形
zquexian=缺陷
zqiangxian=抢险
zqingxi=清洗
zqixi=气息
zqianxin=潜心
zqiexiao=切削
zqiangxian=抢先
zqiaoxiang=敲响
zqiangxiu=抢修
zqixi=栖息
zqiaoxiang=侨乡
zqingxing=庆幸
zqunxiong=群雄
zqinxi=侵袭
zqianxu=谦虚
zquexin=确信
zquanxi=全息
zqingxin=倾心
zqianxi=迁徙
zqixin=齐心
zqiuxing=球形
zqianxun=谦逊
zqixiao=奇效
zqianxian=牵线
zquexi=缺席
zqianxian=浅显
zqingxie=倾泻
zqingxian=清闲
zquxi=屈膝
zqixue=弃学
zqixu=气虚
zquxie=驱邪
zqiuxie=球鞋
zqixi=奇袭
zqiexiao=窃笑
zqunxun=逡巡
zqiye=企业
zquyu=区域
zquanyi=权益
zqiyu=其余
zqiyou=汽油
zquyu=趋于
zqianyan=前沿
zqianyue=签约
zqianyi=迁移
zqianyin=牵引
zqiyue=契约
zqiyong=启用
zquyi=曲艺
zquanyu=痊愈
zqiuyuan=求援
zqiyi=奇异
zqianyi=歉意
zqieyi=惬意
zqiyan=气焰
zqingying=轻盈
zqingying=请缨
zqianyin=铅印
zqianyuan=前缘
zqiaoyu=巧遇
zqueyue=雀跃
zqiya=欺压
zqingyou=清幽
zqiyi=棋艺
zqiuyin=蚯蚓
zqinyuan=亲缘
zquyue=取悦
zqingyuan=情缘
zqiuyi=球艺
zquanyi=权宜
zquanyan=泉眼
zqingya=倾轧
zquanyou=劝诱
zquanyue=圈阅
zqiyu=旗语
zqiyi=起疑
zqunzhong=群众
zqingzhu=庆祝
zqianzi=签字
zqianzai=潜在
zqizhi=旗帜
zqizha=欺诈
zqianzheng=签证
zqianze=谴责
zqizhi=气质
zqingzhu=倾注
zqinzhan=侵占
zqiangzhan=抢占
zqiuzhu=求助
zquzhu=驱逐
zquanzu=劝阻
zquanzi=圈子
zqianzhai=欠债
zquezhen=确诊
zqianzhi=牵制
zqiezi=茄子
zquezao=确凿
zqiangzhuang=强壮
zqunzi=裙子
zqiaozha=敲诈
zqiuzhuang=球状
zqiangzhi=墙纸
zqiaozi=侨资
zquzhi=屈指
zqianzi=铅字
zqiuchang=酋长
zqiezei=窃贼
zqizheng=齐整
zqianzhuang=钱庄
zqianzou=前奏
zqingzheng=清蒸
zqianzi=钳子
zqianzhui=前缀
zqianzhao=前兆
zqizi=旗子
zqizhi=弃置
zqianzhi=潜质
zquezheng=确证
zqianzhi=钳制
zquanze=全责
zqiaozhuang=乔装
zquezi=瘸子
zqingzui=请罪
zqizou=齐奏
zqianzhi=前肢
zshenao=深奥
zshanao=山坳
zsongan=讼案
zshuner=顺耳
zshoue=首恶
zshuini=水泥
zsenlin=森林
zsuliao=塑料
zshuru=输入
zsiliao=饲料
zsiren=私人
zshuailing=率领
zshounao=首脑
zshuniu=枢纽
zshirong=市容
zsiling=司令
zsili=私立
zshanliang=善良
zsongli=送礼
zshulian=熟练
zshili=实例
zshurong=殊荣
zsulv=速率
zshiliang=适量
zshourong=收容
zshuailao=衰老
zshirun=湿润
zshiling=适龄
zshili=视力
zsinve=肆虐
zshuren=熟人
zsaorao=骚扰
zshiliang=矢量
zsongli=耸立
zsili=私利
zshuailuo=衰落
zshourou=瘦肉
zshuilu=水陆
zshouruan=手软
zshoulian=收敛
zshanling=山岭
zshenlou=渗漏
zshenru=渗入
zsanre=散热
zsonglin=松林
zshiliu=石榴
zsaolei=扫雷
zsanluo=散落
zshelie=涉猎
zshanliang=闪亮
zshuli=梳理
zshouruo=瘦弱
zshuanglang=爽朗
zshanlu=山麓
zsanluan=散乱
zshanluan=山峦
zsaoluan=骚乱
zsuona=唢呐
zshenglve=省略
zshouling=首领
zsuannai=酸奶
zshuli=竖立
zshulou=疏漏
zsongruan=松软
zsuli=肃立
zsirong=丝绒
zsulai=素来
zsilie=撕裂
zshuairuo=衰弱
zshunv=淑女
zsile=私了
zsilv=思虑
zshinv=侍女
zsuanla=酸辣
zsunren=损人
zsuanni=蒜泥
zsuolian=锁链
zshinv=仕女
zshanliang=山梁
zsenglv=僧侣
zshoulong=收拢
zsuilie=碎裂
zshiran=释然
zshili=示例
zshalu=杀戮
zshouru=受辱
zshali=沙粒
zshali=沙砾
zsouluo=搜罗
zshiling=拾零
zsuren=俗人
zshengnian=盛年
zshilian=失恋
zsengni=僧尼
zshuiniao=水鸟
zshili=失礼
zshilang=侍郎
zshouna=收纳
zsaniao=撒尿
zshuilian=睡莲
zshualai=耍赖
zselang=色狼
zsuoran=索然
zshuanong=耍弄
zshengnu=盛怒
zsuri=素日
zsuruan=酥软
zshuluo=疏落
zshulan=疏懒
zshengnv=甥女
zsangou=丧偶
zshebei=设备
zshangbiao=商标
zshibai=失败
zshenbao=申报
zshibie=识别
zshenban=申办
zshubiao=鼠标
zshuibeng=水泵
zsanbu=散步
zsanbu=散布
zshoubi=手臂
zshiban=石板
zshabu=纱布
zshibei=石碑
zsongbai=松柏
zshenbing=肾病
zshengbo=声波
zshubian=戍边
zshuaibai=衰败
zshaobing=哨兵
zshoubei=手背
zshuibing=水兵
zshaobing=烧饼
zsoubu=搜捕
zsongbang=松绑
zshenbian=申辩
zshoubei=守备
zshangba=伤疤
zsaibei=塞北
zshangbing=伤兵
zshibao=施暴
zshanben=善本
zsibian=思辨
zshuiba=水坝
zsiban=死板
zshoubing=收兵
zshengbai=胜败
zshubo=叔伯
zshibi=时弊
zsuobian=缩编
zshuaibian=衰变
zsanbing=伞兵
zsabo=撒播
zshabai=煞白
zsanbo=散播
zsiben=私奔
zsuibu=碎步
zshubei=鼠辈
zshucai=蔬菜
zshuchu=输出
zshicha=视察
zsecai=色彩
zsichou=丝绸
zshoucang=收藏
zshengchu=牲畜
zshenchu=伸出
zsaichang=赛场
zsichao=思潮
zshencai=身材
zshengchan=盛产
zshiche=试车
zsaiche=赛车
zshangcan=伤残
zsucai=素材
zsucheng=俗称
zshanchang=擅长
zshanchu=删除
zshache=刹车
zshuchang=舒畅
zshoucuo=受挫
zshichan=试产
zsoucha=搜查
zshechi=奢侈
zsongchi=松弛
zshunchang=顺畅
zsongchao=宋朝
zsangcan=桑蚕
zsuancai=酸菜
zsaicheng=赛程
zshucong=树丛
zshouchen=寿辰
zshancha=山茶
zsucheng=速成
zsicun=思忖
zshachen=沙尘
zsuanchu=酸楚
zshouchao=手抄
zshouchao=受潮
zshichen=时辰
zshenchu=渗出
zshouchang=首倡
zsucai=素菜
zshecheng=射程
zshichong=失宠
zshengchuan=盛传
zsanchang=散场
zshicuo=失措
zshuicai=水彩
zshangci=赏赐
zshice=失策
zshicong=侍从
zshici=誓词
zshuoci=说辞
zshichen=使臣
zshouchang=瘦长
zshachuang=纱窗
zshicong=失聪
zsicang=私藏
zshichi=市尺
zsucan=素餐
zsongci=颂词
zshenchi=申斥
zshicai=适才
zsudu=速度
zshidian=试点
zshidang=适当
zsuoduan=缩短
zshuidao=水稻
zshidu=适度
zsuidao=隧道
zshede=舍得
zshudao=疏导
zsudan=苏丹
zsudong=速冻
zshengda=盛大
zsuidong=隧洞
zsaodang=扫荡
zshidu=湿度
zsongdong=松动
zsuodao=索道
zshidiao=石雕
zsuoding=锁定
zshandong=煽动
zshengdan=圣诞
zshuoda=硕大
zshuaidao=摔倒
zsaodong=骚动
zsudi=速递
zshidao=食道
zshidian=视点
zshuaida=摔打
zshiduan=事端
zsuda=苏打
zshidan=实弹
zshuangdong=霜冻
zshuidi=水滴
zshaodai=捎带
zshengdian=盛典
zshadai=沙袋
zshuidai=睡袋
zsida=厮打
zshoudan=寿诞
zshiduo=拾掇
zsongdu=诵读
zshidi=师弟
zsangdan=丧胆
zsudan=素淡
zshuidou=水痘
zshifou=是否
zshihou=时候
zsunhai=损害
zshifan=示范
zshihe=适合
zsifa=司法
zshifan=师范
zshifang=释放
zshufu=束缚
zsunhuai=损坏
zshifu=师傅
zshihui=实惠
zshenhou=深厚
zsihao=丝毫
zshouhui=受贿
zshangfan=商贩
zshenghui=盛会
zsanfa=散发
zshifei=试飞
zshiheng=失衡
zsonghuo=送货
zshifei=施肥
zsunhao=损耗
zshoufu=首府
zshufu=舒服
zshouhuo=售货
zshanhou=善后
zsuhua=速滑
zshaohui=烧毁
zshuhu=疏忽
zshufa=抒发
zshuihuan=水患
zsuohui=索贿
zsifang=私房
zshanfeng=山峰
zshouhu=守护
zshanhong=山洪
zsifen=私分
zshanghen=伤痕
zshanhu=珊瑚
zshouhou=守候
zsunhui=损毁
zshihao=嗜好
zshuhai=鼠害
zshuihu=水壶
zsuhua=俗话
zsihui=撕毁
zsihou=嗣后
zsanhui=散会
zshuhuan=舒缓
zshihang=试航
zshehua=奢华
zshufu=叔父
zshaohua=韶华
zshahuang=沙荒
zshihuo=识货
zshaohuo=烧火
zsihuan=死缓
zshouheng=守恒
zshihuan=使唤
zshoufen=授粉
zshuohuang=说谎
zsanhuo=散伙
zsahuang=撒谎
zsihuo=私货
zshahuang=沙皇
zshuhuai=抒怀
zshoufan=首犯
zshifeng=侍奉
zshifu=师父
zsifang=私访
zshuanghuang=双簧
zshuhu=倏忽
zshengfu=生父
zshangfa=赏罚
zsifen=私愤
zshefu=慑服
zshenfu=神甫
zsangfu=丧服
zsuohui=缩回
zshuanghai=霜害
zshanhuo=煽惑
zshigong=施工
zshigu=事故
zshuguang=曙光
zshuoguo=硕果
zshangou=山沟
zshigao=石膏
zshouge=收割
zshanggu=商贾
zshougao=手稿
zshiguan=试管
zshuigou=水沟
zshengge=升格
zshugui=书柜
zsongge=颂歌
zshagua=傻瓜
zshengao=审稿
zshengui=深闺
zshuanggang=双杠
zshaigan=晒干
zshiguan=食管
zsigua=丝瓜
zsuogu=锁骨
zshangai=删改
zshigu=世故
zshuigang=水缸
zsanguang=散光
zshegou=赊购
zsougua=搜刮
zshegen=舌根
zshougua=守寡
zshangang=山冈
zshengge=笙歌
zshaoguang=韶光
zshangguang=赏光
zshaogong=艄公
zshugong=叔公
zshaguo=沙锅
zshijie=世界
zshijian=实践
zsheji=涉及
zsiji=司机
zshiji=事迹
zshuji=书籍
zshangjie=商界
zshoujiao=收缴
zsouji=搜集
zshijue=视觉
zshunjian=瞬间
zshijiao=市郊
zshuijing=水晶
zshijia=施加
zshijiao=视角
zsujiao=塑胶
zshuaijian=衰减
zshoujing=受精
zsanjian=散件
zshujia=暑假
zshajun=杀菌
zshejian=射箭
zshuxun=疏浚
zsuojian=缩减
zshuijing=水井
zshijuan=试卷
zshengjie=圣洁
zshuaijiao=摔跤
zshuaijie=衰竭
zshengjiang=生姜
zshijing=市井
zsiji=伺机
zshijian=尸检
zshoujiang=授奖
zshaoji=烧鸡
zshanjie=删节
zsaiji=赛季
zsongjin=松劲
zshouji=手迹
zsanji=散记
zsanju=散居
zshijin=市斤
zsongjin=松紧
zshuijiao=水饺
zshiji=史籍
zshijie=石阶
zshenjiu=深究
zsheji=社稷
zsujiang=宿将
zshoujuan=手绢
zshanji=山脊
zshujian=书简
zshijin=什锦
zsujing=肃静
zshoujie=受戒
zshijiu=嗜酒
zsuji=速记
zshanjian=山涧
zsajiao=撒娇
zshengjing=胜境
zsuijing=绥靖
zsijiao=私交
zshaojiu=烧酒
zshujin=赎金
zshejing=射精
zshajie=杀戒
zshijing=失敬
zsanjia=散架
zshijie=师姐
zsuji=宿疾
zshenke=深刻
zsikao=思考
zshike=时刻
zshikong=失控
zshengkai=盛开
zshengkuang=盛况
zshouke=授课
zshike=石刻
zshikuang=实况
zshuangkuai=爽快
zshikan=试看
zshaokao=烧烤
zshuangkou=爽口
zsuku=诉苦
zshouku=受苦
zsongkai=松开
zshengkou=牲口
zshoukao=手铐
zsikai=撕开
zshenkai=伸开
zshukou=漱口
zsankai=散开
zshikuai=市侩
zsongkou=松口
zsikong=司空
zshenkan=神龛
zshakeng=沙坑
zsongkuai=松快
zshenkui=肾亏
zshenme=什么
zshamo=沙漠
zshouming=寿命
zsaomang=扫盲
zsaomiao=扫描
zshimao=时髦
zshuming=署名
zshengming=盛名
zsima=司马
zshuimian=睡眠
zshanmai=山脉
zsimiao=寺庙
zshumiao=树苗
zshenming=申明
zsumu=肃穆
zshimian=失眠
zsaima=赛马
zsumiao=素描
zshuma=数码
zshamie=杀灭
zshengmu=声母
zsaomu=扫墓
zsangmen=嗓门
zshengmu=生母
zsanman=散漫
zshengmu=圣母
zshumai=赎买
zsangming=丧命
zsuanmiao=蒜苗
zshemian=赦免
zshimu=师母
zshumin=庶民
zshenmi=慎密
zshemi=奢靡
zsuming=宿命
zsiming=嘶鸣
zshimi=失密
zshimei=师妹
zshouming=授命
zshenmiao=神妙
zsuimu=岁暮
zsimu=思慕
zshumu=叔母
zshenmu=婶母
zsemang=色盲
zshangpin=商品
zshipin=食品
zshenpan=审判
zsuopei=索赔
zshanpo=山坡
zshoupian=受骗
zshipin=视频
zshuping=述评
zsuipian=碎片
zshoupin=受聘
zshipu=食谱
zshoupa=手帕
zsaipao=赛跑
zshipo=识破
zshoupi=兽皮
zsipo=撕破
zshengpi=生僻
zshenqing=申请
zshouquan=授权
zsuoqu=索取
zshengqi=升旗
zshuqing=抒情
zsuqu=苏区
zshenqu=身躯
zshaqiu=沙丘
zshuqi=暑期
zshengqing=盛情
zsheqi=舍弃
zsaiqu=赛区
zshenqian=深浅
zshaoka=哨卡
zshangque=商榷
zshangqia=商洽
zsuqing=肃清
zshuiqi=水汽
zshengqian=升迁
zshiqie=失窃
zshuqian=书签
zshuqi=暑气
zsiqiu=死囚
zshuaiqi=帅气
zsiqing=私情
zshengqin=生擒
zsheqiu=奢求
zsheqian=赊欠
zshengqu=生趣
zsangqi=丧气
zshouqi=收讫
zshiqu=识趣
zshishi=实施
zsheshi=设施
zsunshi=损失
zsusong=诉讼
zshuoshi=硕士
zshangsha=商厦
zsushe=宿舍
zsangshi=丧失
zshishi=逝世
zshusong=输送
zshushi=舒适
zshoushi=首饰
zshishi=适时
zsisuo=思索
zshaoshang=烧伤
zsunshang=损伤
zshensu=申诉
zshanshuo=闪烁
zsaishi=赛事
zshenshi=审视
zshenshou=伸手
zshushu=叔叔
zshisu=时速
zshousuo=收缩
zsongsan=松散
zsousuo=搜索
zshixiu=食宿
zshoushi=收拾
zshusan=疏散
zshanshi=膳食
zshensui=深邃
zsangsheng=丧生
zsesu=色素
zsangshi=丧事
zshaoshan=韶山
zshisu=世俗
zsashou=撒手
zshenshi=绅士
zshisan=失散
zshaosuo=哨所
zshunshi=瞬时
zshaoshao=稍稍
zshusong=疏松
zshengshi=盛世
zshenshen=审慎
zsongshu=松树
zshushi=熟食
zsishu=私塾
zshensuo=伸缩
zshengsuo=绳索
zshengshi=盛事
zsishi=私事
zsaishang=塞上
zsuoshi=琐事
zsushi=素食
zshangshi=赏识
zsuoshui=缩水
zshushuo=述说
zsheshui=涉水
zsuosui=琐碎
zshishe=施舍
zshensu=神速
zshusi=殊死
zshushui=熟睡
zsisha=厮杀
zsongshan=嵩山
zshushi=熟识
zsheshen=舍身
zshengshu=生疏
zshishi=誓师
zsanshi=散失
zsese=瑟瑟
zshoushi=收视
zshengshuai=盛衰
zsongshu=松鼠
zsoushen=搜身
zsheshi=涉世
zshushao=树梢
zshanshi=善事
zshashi=霎时
zsuoshi=唆使
zsishi=死尸
zshisi=誓死
zsaoshi=扫视
zsishe=私设
zsangshu=桑树
zshenshu=申述
zsashuang=飒爽
zsishou=厮守
zsisui=撕碎
zshishou=尸首
zshenshen=婶婶
zsaosao=嫂嫂
zsesuo=瑟缩
zshoushou=授受
zsusheng=速胜
zsusha=肃杀
zshengsu=声速
zshushi=术士
zshengtai=生态
zshentou=渗透
zshitang=食堂
zshitu=试图
zshuaitui=衰退
zshiti=尸体
zshitang=食糖
zshatan=沙滩
zshutong=疏通
zshangtao=商讨
zshutan=书摊
zshiti=试题
zshitai=事态
zshentai=神态
zsatuo=洒脱
zshitan=试探
zshengteng=升腾
zshoutuo=受托
zsitu=司徒
zshuitang=水塘
zshetou=舌头
zshitu=师徒
zshitan=诗坛
zshentong=神童
zshuitong=水桶
zsongtao=松涛
zshatang=砂糖
zshutan=舒坦
zshitu=仕途
zsuantong=酸痛
zshoutan=收摊
zshutou=梳头
zsutao=俗套
zshengtao=声讨
zsangtian=桑田
zsuantou=蒜头
zsitun=私吞
zshutian=暑天
zsongti=宋体
zshitai=失态
zsatui=撒腿
zshentui=伸腿
zshoutao=寿桃
zshaitai=晒台
zsitong=私通
zsuowei=所谓
zsiwang=死亡
zshiwei=视为
zshiwu=食物
zshewai=涉外
zshiwu=失误
zsanwen=散文
zshangwang=伤亡
zshengwen=升温
zshiwei=示威
zshiwen=室温
zshaowei=稍微
zshouwan=手腕
zshiwu=饰物
zsaiwai=塞外
zshouwei=收尾
zshewang=奢望
zshouwei=首尾
zshenwei=神威
zsiwa=丝袜
zshengwei=声威
zshiwen=试问
zsuowei=缩微
zshuaiwei=衰微
zshaowei=少尉
zshuaiwang=衰亡
zsawang=撒网
zshanwo=山窝
zshangwu=晌午
zshiwei=侍卫
zshanwa=山洼
zshangwan=赏玩
zshouxu=手续
zshanxi=陕西
zshuxi=熟悉
zshixing=施行
zshixing=试行
zsuoxiao=缩小
zshengxia=剩下
zshengxiao=生效
zshunxu=顺序
zshaoxing=绍兴
zshixiao=实效
zshixiao=适销
zshaixuan=筛选
zsixing=死刑
zshouxi=首席
zshengxing=盛行
zshuxue=输血
zshixiao=失效
zshengxia=盛夏
zshixiao=时效
zshouxiao=收效
zsixia=私下
zsuxiang=塑像
zshixian=视线
zshuaxin=刷新
zsongxie=松懈
zshuixi=水洗
zshixiang=试想
zsuanxing=酸性
zsuoxie=缩写
zsixu=思绪
zshaoxu=少许
zsuoxing=索性
zsouxun=搜寻
zsuxing=苏醒
zsuxie=速写
zshexian=涉嫌
zshuixiang=水箱
zshuxin=舒心
zshexiang=麝香
zshixiao=试销
zshanxing=扇形
zsuxiao=速效
zshouxiao=瘦小
zsuixie=碎屑
zshouxing=寿星
zshaoxiang=烧香
zshexiao=赊销
zshengxiu=生锈
zshouxue=瘦削
zshengxian=圣贤
zshouxing=受刑
zsixin=私心
zshuxie=抒写
zshunxi=吮吸
zshouxun=授勋
zshunxi=瞬息
zshixi=世袭
zshouxian=授衔
zsanxin=散心
zshuaxi=刷洗
zshouxing=兽性
zshuixing=睡醒
zshaoxu=稍许
zshaoxi=稍息
zshanxin=善心
zsuixin=遂心
zshengxi=声息
zshixian=失陷
zsuoxie=琐屑
zsuoxi=琐细
zshuxi=梳洗
zshaxiao=傻笑
zshixiang=识相
zshouxi=收悉
zshenxing=身形
zsixing=肆行
zshexing=蛇行
zshanxiao=讪笑
zshouxing=兽行
zshuxi=熟习
zsixing=私刑
zshexie=蛇蝎
zshiying=适应
zshiyan=试验
zsiying=私营
zshenyang=沈阳
zshiyan=实验
zshouyu=授予
zshouyi=收益
zshenyi=审议
zshengyu=剩余
zshiyong=适用
zshanyu=善于
zshengyin=声音
zshengyu=生育
zshouyi=受益
zsiyang=饲养
zshengyu=声誉
zshiye=视野
zshiyi=适宜
zshengya=生涯
zshiyi=事宜
zshuangyong=双拥
zshouyi=兽医
zshuiyu=水域
zshiyan=食盐
zshiyong=试用
zsiyou=私有
zshuyi=鼠疫
zshiyu=适于
zsuyang=素养
zsuoying=缩影
zsuoyao=索要
zsunyi=损益
zshengyu=盛誉
zsuyuan=夙愿
zsheyan=设宴
zshangyi=商议
zshanyang=赡养
zshiyu=食欲
zsuanyu=酸雨
zshiyan=誓言
zshuye=输液
zshanye=山野
zsuoyin=索引
zshanyao=闪耀
zshenyue=审阅
zshiyou=食油
zshenyuan=深渊
zshouyi=手艺
zsiyi=肆意
zshenyun=神韵
zshiyan=饰演
zshanyao=山腰
zshanyi=善意
zsangyin=嗓音
zshenyin=呻吟
zsuyou=酥油
zshuyuan=疏远
zsongyang=颂扬
zsuyuan=溯源
zsenyan=森严
zshuaya=刷牙
zshuiyin=水银
zshengyuan=声援
zshouyi=授意
zshanyu=鳝鱼
zsuyu=俗语
zshuying=输赢
zsuying=宿营
zshiyi=释疑
zsiyu=私欲
zshenyan=肾炎
zshiyi=释义
zshanya=山崖
zsuya=素雅
zshunyan=顺延
zsongyong=怂恿
zsuyuan=宿愿
zshenyi=神医
zsiya=嘶哑
zshouyun=受孕
zshaya=沙哑
zshayu=鲨鱼
zshenyou=神游
zshanyue=山岳
zshaoyao=芍药
zshuyang=输氧
zshouyin=收音
zshengyi=生疑
zsuoyi=蓑衣
zshouying=首映
zshengyan=盛宴
zshaoye=少爷
zsuoyin=缩印
zshiyan=食言
zsuoyue=锁钥
zshiying=试映
zshouyi=寿衣
zsiyu=私语
zsaye=撒野
zshiyue=誓约
zshouyin=手淫
zshenyuan=申冤
zsuiyuan=遂愿
zsuyuan=宿怨
zshenyuan=伸冤
zshiyu=施与
zsiyuan=私怨
zshiyuan=誓愿
zshouyu=兽欲
zsuiyi=遂意
zshuangyue=爽约
zshenzhen=深圳
zsuzhi=素质
zshizhong=始终
zshezhi=设置
zsuzhou=苏州
zshanzi=擅自
zshizhi=实质
zsuzao=塑造
zshuizhun=水准
zshengzhu=生猪
zshuizhi=水质
zshenzhou=神州
zsichang=司长
zshenzhong=慎重
zshizhan=施展
zseze=色泽
zshezu=涉足
zshouzu=受阻
zshizong=失踪
zsanzhuang=散装
zsizi=私自
zshanzhuang=山庄
zshizhong=适中
zshengzhi=生殖
zshanzha=山楂
zshazi=傻子
zshizi=狮子
zshizi=识字
zshuzhi=熟知
zshizhong=时钟
zsangzi=嗓子
zshengzi=绳子
zshuzhi=树枝
zshengzan=盛赞
zsuzhuang=诉状
zshuzhan=舒展
zshuazi=刷子
zsangzang=丧葬
zshenzhan=伸展
zshizi=柿子
zshizheng=施政
zshengzhuang=盛装
zshuzhuo=书桌
zshenzang=肾脏
zshuizha=水闸
zshanzhai=山寨
zshuzhai=书斋
zshizu=始祖
zshizhi=食指
zsaozi=嫂子
zshenzhang=伸张
zsongzang=送葬
zshanzi=扇子
zshengzhang=胜仗
zsaozhou=扫帚
zshanzhan=善战
zshouzhuo=手镯
zshouzui=受罪
zsangzi=桑梓
zshizhi=矢志
zshizhong=示众
zsuozi=梭子
zsizhu=丝竹
zshouzhang=手杖
zshuzi=梳子
zshenzi=身姿
zshazi=啥子
zshuzhang=舒张
zsongzhong=送终
zshuzhuang=梳妆
zshaozi=哨子
zsongzi=松子
zshaizi=筛子
zshuzui=赎罪
zshuzhi=述职
zshenzhi=深挚
zshaozi=勺子
zshaozhuo=烧灼
zsizui=死罪
zshuangzhi=爽直
zshazhi=砂纸
zshezhan=舌战
zsangzhong=丧钟
zshizhe=侍者
zshouzhi=收执
zshenzi=婶子
zshaozhuang=少壮
zshuzu=叔祖
zsaizi=塞子
zsizhang=私章
zshangzhuo=商酌
zshuizao=水藻
zshanzhong=善终
zseze=塞责
ztengai=疼爱
ztiane=天鹅
ztaier=胎儿
ztonge=痛恶
ztiaoli=条例
ztaolun=讨论
zturan=突然
zturang=土壤
ztoulu=透露
ztounao=头脑
ztuoli=脱离
ztuliao=涂料
ztongren=同仁
ztangruo=倘若
ztongnian=童年
ztilian=提炼
ztuoluo=脱落
ztuili=推理
ztongling=同龄
ztanran=坦然
ztuili=推力
ztaoli=桃李
ztianliang=天亮
ztanlan=贪婪
ztaoran=陶然
ztiliang=体谅
ztoulu=头颅
ztingli=挺立
ztanli=弹力
ztianliao=填料
ztanlu=探路
ztili=体例
ztulao=徒劳
ztuilun=推论
ztuola=拖拉
ztoulan=投篮
ztongling=统领
ztuolei=拖累
ztulu=吐露
ztouliang=透亮
ztilan=提篮
ztuoluo=陀螺
ztuanliu=湍流
ztuina=推拿
ztianluan=添乱
ztielian=铁链
ztonglan=通栏
zteli=特例
ztuoling=驼铃
ztoulan=偷懒
ztaolve=韬略
ztaoren=桃仁
ztianluo=田螺
ztianrun=甜润
zturan=徒然
ztongli=通例
ztuli=图例
ztaoni=逃匿
ztanruan=瘫软
ztuirang=推让
ztanlian=贪恋
ztanglang=螳螂
ztuiran=颓然
ztongliao=同僚
ztongren=瞳仁
ztaorao=讨饶
ztuanling=团龄
ztenglu=誊录
ztongbao=同胞
ztoubiao=投标
ztianbu=填补
ztaibao=台胞
ztiba=提拔
ztiebu=贴补
ztongban=同伴
ztaban=踏板
ztubiao=图标
ztiaoban=跳板
ztubian=突变
ztingba=挺拔
ztubu=徒步
ztianbao=填报
ztanbai=坦白
ztuibian=蜕变
ztunbing=吞并
ztiebing=铁饼
ztibu=替补
ztabu=踏步
ztuobei=驼背
ztongbei=同辈
ztiaobo=挑拨
ztaobing=逃兵
ztunbing=屯兵
ztongbi=铜币
ztiba=题跋
ztuibai=颓败
ztanbing=探病
ztuoba=拖把
ztianbu=添补
ztanbei=贪杯
ztiebian=贴边
ztuchu=突出
ztuichu=推出
ztongchou=统筹
ztaoci=陶瓷
ztichang=提倡
zticai=题材
zticao=体操
ztance=探测
ztuichi=推迟
ztancheng=坦诚
ztiancai=甜菜
ztiaocao=跳槽
ztuichong=推崇
ztuice=推测
ztianchong=填充
ztichu=剔除
ztouche=透彻
ztangchao=唐朝
ztongchang=通畅
ztangci=搪瓷
ztuochan=脱产
zticai=体裁
ztuici=推辞
zticha=体察
ztaocuan=逃窜
ztongchuang=同窗
ztianci=天赐
ztiechui=铁锤
ztiechuang=铁窗
ztichun=提纯
ztancha=探查
ztuoche=拖车
ztongchi=痛斥
ztongchu=痛楚
ztuichao=退潮
ztianci=填词
ztoucheng=投诚
ztangchi=汤匙
ztuchang=屠场
ztiaoci=挑刺
ztancai=贪财
ztuidong=推动
ztaidu=态度
ztandian=摊点
ztoudu=偷渡
ztoudi=投递
ztoudao=偷盗
ztudi=徒弟
ztuiduan=推断
ztuidao=推倒
ztandang=坦荡
ztidui=梯队
ztaidou=泰斗
ztuidao=推导
ztiandan=恬淡
ztudao=屠刀
ztiaodou=挑逗
ztuota=拖沓
ztouding=透顶
ztaodun=逃遁
ztongdie=通牒
ztuding=秃顶
ztiaodong=挑动
ztidao=剃刀
ztudu=荼毒
ztengfei=腾飞
ztaihu=太湖
ztanhuan=瘫痪
ztanhuang=弹簧
ztonghang=通航
ztuihuo=退货
ztufa=突发
ztuifan=推翻
ztonghua=童话
ztaohua=桃花
ztihuo=提货
ztafang=塌方
ztianfu=天赋
ztuohuang=拓荒
ztianhuang=天皇
ztanfan=摊贩
ztanfang=探访
ztaofan=逃犯
ztufei=土匪
ztaofan=讨饭
ztonghuo=通货
ztaohao=讨好
ztuifei=颓废
ztoufeng=透风
ztanhu=袒护
ztaohong=桃红
ztuofu=托付
ztaohuang=逃荒
ztufan=吐蕃
ztinghou=听候
ztuofu=托福
ztuofa=脱发
ztanhuo=炭火
ztaofa=讨伐
ztufu=屠夫
ztanhe=弹劾
ztaohai=讨还
ztuhao=土豪
ztiaofu=挑夫
ztanhua=昙花
ztuihua=蜕化
ztonghui=痛悔
ztanhua=探花
ztunfu=吞服
ztafa=挞伐
ztuiguang=推广
ztaiguo=泰国
ztiaogui=条规
ztouguo=透过
ztonggao=通告
ztuoguan=托管
ztangguo=糖果
ztuogou=脱钩
ztugai=涂改
ztonggong=童工
ztougao=投稿
ztige=体格
ztouguang=透光
ztiangua=甜瓜
ztiangeng=田埂
ztuogui=脱轨
ztange=探戈
ztanguan=贪官
ztuogao=脱稿
ztaigang=抬杠
ztiaogeng=调羹
ztuogu=托故
ztianjin=天津
ztuijin=推进
ztujing=途径
ztaijie=台阶
ztuijian=推荐
ztiaoji=调剂
ztianjing=田径
ztianjia=添加
ztiji=体积
ztuji=突击
ztiejin=贴近
ztuojie=脱节
ztingjin=挺进
ztuanju=团聚
ztaojin=淘金
ztanjiu=探究
ztuiju=推举
ztingju=挺举
ztiji=梯级
ztongji=通缉
ztianjing=恬静
zteji=特技
ztunji=囤积
ztangjing=糖精
ztaijian=太监
ztuijiao=腿脚
ztoujin=头巾
ztangjin=烫金
ztuanji=湍急
ztoujing=透镜
ztianjing=天井
ztiejia=铁甲
ztiejin=贴金
ztiaojian=挑拣
ztianjiu=甜酒
ztuojiu=脱臼
ztanjian=探监
zteji=特辑
ztongjian=通奸
ztaijiao=胎教
ztaiji=胎记
ztuijiu=推究
zdiaokong=调控
ztongku=痛苦
ztiekuang=铁矿
ztanke=坦克
ztengkong=腾空
ztingke=听课
ztiaokan=调侃
ztongkao=统考
ztunken=屯垦
ztuokua=拖垮
ztoukui=头盔
ztingke=停课
ztongkong=瞳孔
ztiankong=填空
ztoukao=投考
ztoukan=偷看
ztaoke=逃课
ztouming=透明
ztanming=探明
ztumou=图谋
ztianmi=甜蜜
ztunmei=吞没
ztuomang=脱盲
ztianmei=甜美
ztumo=涂抹
ztuomo=唾沫
ztongmou=同谋
ztuoma=唾骂
ztuimi=颓靡
ztunmie=吞灭
ztupo=突破
ztanpan=谈判
ztanpai=摊派
ztuopin=脱贫
ztongpai=铜牌
ztiaopei=调配
ztongpei=统配
zdiaopin=调频
ztipo=体魄
ztuipei=退赔
ztupi=土坯
ztupu=图谱
ztuopan=托盘
ztaipan=胎盘
ztuopi=脱皮
ztingping=听凭
ztanpai=摊牌
ztuoqian=拖欠
ztanqin=探亲
ztiaoqi=挑起
ztouqi=透气
ztanqiu=探求
ztaoqi=陶器
ztuiqiao=推敲
ztuqi=突起
ztiqin=提琴
ztieqie=贴切
ztouqie=偷窃
ztianqian=天堑
ztaoqi=淘气
ztongqian=铜钱
ztanqin=弹琴
ztuoqi=唾弃
ztaqing=踏青
ztieqi=铁骑
ztouqing=偷情
ztuique=推却
ztanqiu=贪求
ztiqie=提挈
zteshu=特殊
ztansuo=探索
ztangshan=唐山
ztaishi=态势
ztuoshan=妥善
ztongsu=通俗
ztiaoshi=调试
ztaishan=泰山
ztoushui=偷税
ztoushi=透视
ztusha=屠杀
ztashi=踏实
ztanshuai=坦率
ztuoshui=脱水
ztuisuan=推算
ztunshi=吞噬
ztuisuo=退缩
ztingshen=庭审
ztangshi=唐诗
ztongshuai=统帅
ztoushe=透射
ztiaosan=跳伞
ztuise=褪色
ztieshen=贴身
ztanshi=探视
ztuosu=脱俗
ztangshang=烫伤
ztaoshu=桃树
ztuoshou=脱手
ztunshi=吞食
ztuoshen=脱身
ztianshi=甜食
ztangshou=烫手
ztiesuo=铁索
ztangse=搪塞
ztaisheng=胎生
ztuishi=颓势
ztuishao=退烧
ztangshang=堂上
ztingshen=挺身
ztanshe=弹射
ztushou=徒手
ztiaoshi=挑食
ztuishuo=推说
zteshe=特赦
ztaose=桃色
ztiaosheng=跳绳
ztangshi=倘使
ztuisang=颓丧
ztianshe=添设
ztianshu=田鼠
ztianshe=田舍
ztousheng=头绳
ztianshi=恬适
ztiansai=田赛
ztiaosuo=挑唆
ztantao=探讨
ztaotai=淘汰
ztengtong=疼痛
ztantu=滩涂
ztiantang=天堂
ztuntu=吞吐
ztiantou=甜头
ztoutou=偷偷
ztiaoti=挑剔
ztiantan=天坛
ztitan=体坛
ztaotao=滔滔
ztitian=梯田
ztouteng=头疼
ztantu=贪图
ztaotuo=逃脱
ztitie=体贴
ztangtang=堂堂
ztantu=坦途
ztanta=坍塌
ztantu=谈吐
ztuteng=图腾
ztingtang=厅堂
ztitai=体态
ztaotian=滔天
ztantou=滩头
ztongtu=通途
ztiaotiao=迢迢
ztuituo=推脱
zdantiao=弹跳
ztingtong=听筒
ztuotao=脱逃
ztuituo=推托
ztanting=探听
ztingting=亭亭
ztouting=偷听
ztianti=天梯
ztangtu=唐突
ztengtiao=藤条
ztianting=天庭
ztuiting=退庭
ztutou=秃头
ztuitang=颓唐
ztuotu=脱兔
ztoutai=投胎
ztaiwan=台湾
ztanwu=贪污
ztanwei=摊位
ztuiwu=退伍
ztanwang=探望
ztiaowu=跳舞
ztuwei=突围
ztiwei=体味
ztiaowei=调味
ztiwen=体温
ztiaowang=眺望
ztaowang=逃亡
ztuwu=突兀
ztianwei=甜味
ztangwu=堂屋
ztanwan=贪玩
ztiewan=铁腕
ztuixing=推行
ztuixiao=推销
ztuxing=图形
ztixing=提醒
ztiaoxuan=挑选
ztanxing=弹性
ztianxie=填写
ztexu=特许
ztanxian=探险
ztiexian=贴现
ztiexi=贴息
ztuixuan=推选
ztaxian=塌陷
ztanxi=叹息
ztanxun=探寻
ztouxian=头衔
ztongxiang=铜像
ztuixie=推卸
ztuoxiao=脱销
ztuoxie=拖鞋
ztixing=体形
ztuoxian=脱险
ztexiao=特效
ztongxin=童心
ztuxing=徒刑
ztiaoxie=调谐
ztiaoxin=挑衅
ztouxi=透析
ztixing=体型
ztingxi=停息
ztiexin=贴心
ztongxi=痛惜
ztongxiao=通晓
ztaixian=苔藓
ztouxu=头绪
ztixing=梯形
ztouxi=偷袭
ztuxi=突袭
ztingxie=停歇
ztianxian=天险
ztanxiang=檀香
ztuxie=吐血
ztixie=提携
ztanxun=探询
ztouxian=偷闲
ztongxia=统辖
ztuixiang=推想
ztixiang=提箱
ztengxie=誊写
ztanxin=贪心
ztuixi=退席
ztingxin=停薪
ztaoxian=讨嫌
ztiyu=体育
ztiyan=体验
ztingyuan=庭院
ztiyi=提议
ztiaoyue=跳跃
ztianye=田野
zteyao=特邀
ztuoyan=拖延
ztuiyi=退役
ztuoyuan=椭圆
ztuiyi=推移
zteyi=特异
ztaoye=陶冶
ztuoyun=托运
ztuanyuan=团圆
ztianya=天涯
ztaoyan=讨厌
ztiye=体液
ztuoye=唾液
ztaoyi=逃逸
ztangyuan=汤圆
ztianya=填鸭
ztengyi=藤椅
ztanyu=痰盂
ztangyao=汤药
ztongyin=痛饮
ztaiye=太爷
ztangyi=躺椅
ztuoye=拖曳
ztongyao=童谣
ztuya=涂鸦
ztouyuan=投缘
ztanya=弹压
ztiaozheng=调整
ztiaozhan=挑战
ztuzhong=途中
ztuzhi=图纸
ztuzai=屠宰
ztingzhong=听众
ztanzi=摊子
ztizhi=体质
ztaozui=陶醉
ztianzhi=添置
ztingzhi=停滞
ztongzhuang=童装
ztouzhi=透支
ztingchang=庭长
ztuzi=兔子
ztaozhai=讨债
ztuzang=土葬
ztuozhi=脱脂
ztuzhang=图章
ztuizhan=推展
ztaozi=桃子
zdanzou=弹奏
ztizi=梯子
ztouzhi=投掷
ztanzi=毯子
ztongzi=童子
ztingzi=亭子
ztiaozao=跳蚤
ztiaozhou=笤帚
ztiaozha=跳闸
ztanzhi=探知
ztanzang=贪赃
ztuzi=秃子
ztongzhen=童贞
ztiezi=帖子
ztongze=痛责
zweiai=胃癌
zweiao=违拗
zweie=巍峨
zwuran=污染
zwangluo=网络
zweirao=围绕
zwennuan=温暖
zweilie=伪劣
zwunai=无奈
zweili=威力
zwuru=侮辱
zwuli=武力
zweiren=伟人
zweinan=危难
zwenluan=紊乱
zwenrou=温柔
zwanliu=挽留
zwanlu=弯路
zwulin=武林
zweinan=畏难
zwuliao=无聊
zwuni=污泥
zweiruan=微软
zwoniu=蜗牛
zweilan=蔚蓝
zwanlian=挽联
zweiran=巍然
zwali=瓦砾
zwuru=污辱
zwenli=纹理
zweilao=慰劳
zwonang=窝囊
zweilong=围拢
zwuli=无礼
zwenlu=纹路
zwenliang=温良
zwulai=无赖
zwuning=毋宁
zwanlai=万籁
zwangran=枉然
zwenrun=温润
zweili=违例
zwunv=舞女
zweilou=危楼
zwanli=腕力
zwanlie=顽劣
zwaili=歪理
zwangran=惘然
zwuni=忤逆
zwulai=诬赖
zwanou=玩偶
zwenbao=温饱
zwenbu=稳步
zwanbi=完毕
zweibei=违背
zwanbei=完备
zweibo=微波
zwaibi=外币
zweiba=尾巴
zweibao=微薄
zwaibu=外埠
zweibu=尾部
zwubi=舞弊
zwanbei=晚辈
zweibi=威逼
zwobing=卧病
zwubu=舞步
zwobie=握别
zwuban=舞伴
zweibei=魏碑
zweibu=围捕
zwubei=吾辈
zwucha=误差
zwuchang=武昌
zwucan=午餐
zwachu=挖出
zweicheng=围城
zwencha=温差
zwancan=晚餐
zwenchuang=温床
zwochuang=卧床
zweichao=伪钞
zwuchang=舞场
zwocang=窝藏
zwoche=卧车
zwuchi=舞池
zwangchu=王储
zwencun=温存
zweichang=未尝
zwucan=误餐
zwuchuan=误传
zwochuo=龌龊
zweicong=苇丛
zweicheng=危城
zwangchong=网虫
zwending=稳定
zweida=伟大
zwendu=温度
zwudao=舞蹈
zweidao=味道
zwudao=误导
zweidu=唯独
zwendai=温带
zwandou=豌豆
zweidu=纬度
zwuduan=无端
zwadi=洼地
zwuda=武打
zwuduan=武断
zwending=问鼎
zwudou=武斗
zwudong=舞动
zwendang=稳当
zwandan=完蛋
zwudian=污点
zwudian=误点
zwudao=悟道
zwandi=顽敌
zweidai=危殆
zwodi=卧底
zwangdong=妄动
zweihu=维护
zwaihui=外汇
zweifa=违法
zweifan=违反
zwuhan=武汉
zweihai=危害
zwenhou=问候
zwangfan=往返
zwanhui=挽回
zweifang=危房
zwenhe=温和
zwanfan=晚饭
zwaifeng=歪风
zwafang=瓦房
zwangfu=王府
zwufan=午饭
zweifan=违犯
zwuhui=误会
zwuhui=舞会
zweifeng=威风
zwuhou=午后
zwuhei=乌黑
zwenhao=文豪
zwuhui=污秽
zwangfa=枉法
zwufu=武夫
zweixia=威吓
zwohuo=窝火
zwenhou=温厚
zwanghou=王侯
zwangfei=枉费
zwuhou=物候
zwuhai=诬害
zwugang=武钢
zwengu=稳固
zwengao=文稿
zwugu=无辜
zweiguan=围观
zwugu=无故
zweigui=违规
zweigong=围攻
zwangu=顽固
zwugong=武功
zwugou=污垢
zwugong=误工
zwugao=诬告
zweigan=桅杆
zwengao=文告
zwangguan=王冠
zwagong=瓦工
zwugui=乌龟
zwugong=蜈蚣
zwange=挽歌
zwogong=窝工
zwaguan=瓦罐
zwenggu=翁姑
zweiji=危机
zwujing=武警
zwajue=挖掘
zweiji=违纪
zweijing=味精
zwaijie=外界
zwujie=误解
zwaiji=外籍
zwangji=旺季
zweiji=危及
zwuju=舞剧
zwanjiu=挽救
zweiji=危急
zwenjian=稳健
zwuji=屋脊
zweijiao=围剿
zwajie=瓦解
zweiju=畏惧
zweijin=违禁
zwenjing=文静
zweijue=味觉
zweijin=围巾
zweijie=慰藉
zweijian=围歼
zwujin=乌金
zwujian=午间
zwoju=蜗居
zwajiang=瓦匠
zwoju=莴苣
zweiju=危局
zweijing=胃镜
zweikun=围困
zwaike=外壳
zweikong=唯恐
zwukui=无愧
zwankuai=碗筷
zwaku=挖苦
zwokou=倭寇
zweikang=违抗
zwankang=顽抗
zwanku=纨绔
zwenmang=文盲
zweimu=帷幕
zweimiao=微妙
zweimian=未免
zweimian=卫冕
zwumei=妩媚
zwumie=诬蔑
zwaimao=外貌
zweiming=威名
zwumie=污蔑
zwumian=晤面
zweimeng=威猛
zweimi=萎靡
zweimian=慰勉
zwuma=误码
zwumi=舞迷
zwupin=物品
zwenping=文凭
zwopu=卧铺
zwaipo=外婆
zwanpi=顽皮
zwopeng=窝棚
zwupo=巫婆
zwapian=瓦片
zwuqi=武器
zwanqiang=顽强
zwuqu=误区
zweiqi=围棋
zwuqiong=无穷
zwaqian=挖潜
zwenquan=温泉
zwanqu=弯曲
zweiqiang=围墙
zweiqu=委屈
zwaiqu=歪曲
zwenqing=温情
zwuqu=舞曲
zwuqi=雾气
zwaiqin=外勤
zweiqun=围裙
zweiqie=畏怯
zwuqian=午前
zwanshan=完善
zwushui=污水
zwushu=武术
zweisuo=萎缩
zwangsheng=旺盛
zwenshi=温室
zwoshou=握手
zwusi=无私
zwushi=无视
zwasi=瓦斯
zwoshi=卧室
zwusun=无损
zweisheng=尾声
zweishe=威慑
zweisuo=微缩
zwanshua=玩耍
zweisui=尾随
zwaisheng=外甥
zwushi=午时
zwenshui=温水
zwushi=武士
zweisui=未遂
zwenshun=温顺
zweishu=尾数
zwushi=误事
zwanshu=晚熟
zwenshen=瘟神
zwusheng=武生
zweisuo=畏缩
zweisuan=胃酸
zwushui=午睡
zwushang=误伤
zwanshang=玩赏
zwushu=巫术
zwushi=误时
zweishu=卫戍
zweishan=伪善
zweishi=威势
zwushi=巫师
zweisuo=猥琐
zwosun=莴笋
zwusha=误杀
zweituo=委托
zwutai=舞台
zwentuo=稳妥
zwentan=文坛
zwuting=舞厅
zwotu=沃土
zwutong=梧桐
zwangtu=妄图
zwotou=窝头
zwate=瓦特
zwantong=顽童
zweitang=苇塘
zwota=卧榻
zweiwen=慰问
zwawa=娃娃
zwaiwei=外围
zweiwang=威望
zweiwu=威武
zweiwei=巍巍
zwuwu=无误
zweiwei=娓娓
zwuwei=无味
zweiwan=委婉
zwuwei=无畏
zwuwei=无谓
zwanwei=玩味
zweiwang=危亡
zwengweng=嗡嗡
zwawa=哇哇
zwangwei=妄为
zweixian=危险
zweixie=威胁
zwuxing=无形
zwenxian=文献
zweixing=微型
zwuxiao=无效
zwenxin=温馨
zweixin=威信
zwaixing=外形
zwuxia=武侠
zwuxia=无暇
zwanxi=惋惜
zwangxi=往昔
zwenxiang=蚊香
zwoxuan=斡旋
zwuxing=悟性
zwuxian=诬陷
zwanxia=晚霞
zwaixian=外县
zweixin=违心
zwuxiu=午休
zwuxu=务虚
zwangxiang=妄想
zwaixie=歪斜
zwanxie=婉谢
zwenxi=温习
zwenxun=温驯
zweixie=猥亵
zweixian=纬线
zwenyi=文艺
zwuyi=无疑
zweiyou=唯有
zweiyue=违约
zweiyang=喂养
zweiyi=为宜
zwuyuan=无缘
zwenyu=文娱
zwuye=午夜
zwanyan=蜿蜒
zweiyi=位移
zweiyan=威严
zwuyi=无异
zwenyi=瘟疫
zwuyi=武艺
zwanyan=晚宴
zwuyun=乌云
zwaiyuan=外援
zweiye=伟业
zwuyin=无垠
zwanyao=弯腰
zwuyi=无益
zwayong=蛙泳
zwanyu=晚育
zwenying=蚊蝇
zwuyan=屋檐
zwanyan=婉言
zwoye=沃野
zweiyi=逶迤
zwuye=呜咽
zwenyuan=文苑
zwuya=乌鸦
zwuyong=误用
zwanyue=婉约
zwangye=王爷
zweiye=胃液
zwangye=网页
zwuzhi=物质
zweizhi=位置
zwenzhang=文章
zwanzheng=完整
zwuzhuang=武装
zweizao=伪造
zweizhang=违章
zweizhun=为准
zwenzhu=稳住
zwenzhai=文摘
zwaizhai=外债
zwozhu=握住
zwazi=袜子
zwanzheng=顽症
zwuzui=无罪
zweizhuang=伪装
zwenzi=蚊子
zwuzi=舞姿
zwanzhuan=婉转
zweizhong=危重
zwuzhuo=污浊
zwenzhong=稳重
zweizheng=伪证
zwenzhang=蚊帐
zwangzu=望族
zwuzei=乌贼
zwozang=窝赃
zwuza=芜杂
zwenzui=问罪
zweizui=畏罪
zwuzi=污渍
zwangzu=王族
zwangzhi=网址
zxiai=喜爱
zxiaai=狭隘
zxuanan=悬案
zxuanao=玄奥
zxiaer=遐迩
zxiee=邪恶
zxiane=险恶
zxionge=凶恶
zxinger=幸而
zxiaolv=效率
zxiri=昔日
zxianru=陷入
zxueruo=削弱
zxina=吸纳
zxila=希腊
zxiren=喜人
zxinlai=信赖
zxiaoli=效力
zxunluo=巡逻
zxinglong=兴隆
zxiuli=秀丽
zxinran=欣然
zxianli=先例
zxiangliang=响亮
zxingrong=形容
zxuanlv=旋律
zxiaoneng=效能
zxuanli=绚丽
zxianlu=显露
zxiaorong=笑容
zxianglin=相邻
zxulie=序列
zxiangle=享乐
zxini=细腻
zxianglian=项链
zxiniu=犀牛
zxialiang=夏粮
zxini=悉尼
zxuerou=血肉
zxielou=泄漏
zxili=洗礼
zxuni=虚拟
zxunli=巡礼
zxiari=夏日
zxuanran=渲染
zxinlao=辛劳
zxunuo=许诺
zxianlie=先烈
zxuruo=虚弱
zxielu=泄露
zxiangnian=享年
zxueling=学龄
zxiannen=鲜嫩
zxuannao=喧闹
zxiangrong=相容
zxinlang=新郎
zxinglv=刑律
zxingren=杏仁
zxiaorong=消融
zxiulian=修炼
zxiongnu=匈奴
zxianliao=闲聊
zxiliu=溪流
zxianluo=陷落
zxianli=献礼
zxiaren=虾仁
zxianliang=鲜亮
zxianren=闲人
zxieren=卸任
zxunnan=殉难
zxurong=虚荣
zxuannian=悬念
zxingnang=行囊
zxili=犀利
zxianglu=香炉
zxiuru=羞辱
zxingli=行礼
zxuanlan=绚烂
zxinen=细嫩
zxuanniu=旋钮
zxinla=辛辣
zxianglian=相恋
zxiangrui=祥瑞
zxianren=贤人
zxianruo=纤弱
zxirao=袭扰
zxiaolao=效劳
zxinao=嬉闹
zxueliang=雪亮
zxiran=洗染
zxunran=熏染
zxianliang=贤良
zxianneng=贤能
zxiluo=奚落
zxiruan=细软
zxinglv=行旅
zxinruan=心软
zxulun=绪论
zxilan=稀烂
zxuanrang=喧嚷
zxiongrui=雄蕊
zxinu=息怒
zxiunan=羞赧
zxianglve=详略
zxunliang=驯良
zxuanrao=喧扰
zxianao=瞎闹
zxuanrao=旋绕
zxieni=斜睨
zxiangli=襄理
zxuanbu=宣布
zxibao=细胞
zxuanba=选拔
zxubao=虚报
zxinbing=新兵
zxiubu=修补
zxianbing=宪兵
zxianbei=先辈
zxiongbian=雄辩
zxuebeng=雪崩
zxibie=惜别
zxibo=稀薄
zxiangbin=香槟
zxibao=喜报
zxiaobing=笑柄
zxubian=续编
zxianbao=献宝
zxiangbei=详备
zxunbu=巡捕
zxiebian=斜边
zxiongbao=凶暴
zxiongbing=雄兵
zxiubing=休兵
zxingcheng=形成
zxuanchuan=宣传
zxiaochu=消除
zxiancheng=县城
zxinchao=新潮
zxuchan=畜产
zxingcheng=行程
zxuancheng=宣称
zxiancai=咸菜
zxican=西餐
zxieche=卸车
zxiaochuan=哮喘
zxuancai=选材
zxiuci=修辞
zxingchen=星辰
zxiangchang=香肠
zxunchi=训斥
zxiaochen=消沉
zxiachang=狭长
zxianchao=现钞
zxiangche=响彻
zxingchang=刑场
zxiangchun=香椿
zxingcun=幸存
zxiongcan=凶残
zxinchao=心潮
zxiancai=贤才
zxinchang=心肠
zxiaci=瑕疵
zxichen=洗尘
zjiachi=挟持
zxianci=献词
zxiuchi=羞耻
zxingchou=腥臭
zxuechao=学潮
zxuci=虚词
zxiucan=羞惭
zxingcha=省察
zxiaoci=消磁
zxiaochou=消愁
zxiecong=胁从
zxianchou=献丑
zxiache=瞎扯
zxuduo=许多
zxindai=信贷
zxiongdi=兄弟
zxiedai=携带
zxiaodu=消毒
zxidi=洗涤
zxuandu=宣读
zxiangdi=相抵
zxiedai=懈怠
zxiedi=鞋底
zxiedian=鞋垫
zxiedu=亵渎
zxiedai=鞋带
zxudu=虚度
zxideng=熄灯
zxiangdi=箱底
zxiaodao=孝道
zxiande=贤德
zxiandan=仙丹
zxudao=絮叨
zxiande=险地
zxuedao=穴道
zxiaofei=消费
zxihuan=喜欢
zxiaohao=消耗
zxiaofang=消防
zxingfu=幸福
zxiaohua=消化
zxionghou=雄厚
zxunhuan=循环
zxingfen=兴奋
zxianfa=宪法
zxianhua=鲜花
zxinghao=型号
zxianfeng=先锋
zxiongfeng=雄风
zxianhuo=现货
zxingfa=刑法
zxuanfu=悬浮
zxiangfu=相符
zxifu=吸附
zxifu=媳妇
zxinhan=信函
zxuanfeng=旋风
zxianhuo=鲜活
zxuefu=学府
zxinghui=行贿
zxianghe=祥和
zxuehan=血汗
zxianhe=显赫
zxiaofan=小贩
zxiuhua=绣花
zxuhao=序号
zxingfa=刑罚
zxinfeng=信奉
zxionghun=雄浑
zxianhong=鲜红
zxiaohuo=销货
zxiaofang=效仿
zxuhong=蓄洪
zxiehong=泄洪
zxihao=喜好
zxionghen=凶狠
zxiehuo=卸货
zxinghao=幸好
zxianhua=献花
zxihan=稀罕
zxinfei=心扉
zxifan=稀饭
zxuanhua=喧哗
zxiongfan=凶犯
zxiangfang=相仿
zxiangfeng=相逢
zxuhuan=虚幻
zxihuo=熄火
zxianhua=闲话
zxiaofa=效法
zxunhua=驯化
zxianhai=陷害
zxiahu=吓唬
zxiangfang=厢房
zxinfu=心腹
zxianfeng=险峰
zxinhuang=心慌
zxunfu=驯服
zxianhui=贤惠
zxiangfu=享福
zxianhe=仙鹤
zxinhui=信汇
zxinfan=心烦
zxinghuang=杏黄
zxinghong=猩红
zxiehuang=蟹黄
zxinfeng=薪俸
zxiangfu=降伏
zxuhan=虚汗
zxiaohui=校徽
zxiefen=泄愤
zxihan=希罕
zxionghan=凶悍
zxufu=虚浮
zxuhuan=徐缓
zxinhuan=新欢
zxiaohun=销魂
zxinhen=心狠
zxiehen=泄恨
zxiaoguo=效果
zxingge=性格
zxuangao=宣告
zxigua=西瓜
zxiangei=献给
zxuangua=悬挂
zxianggu=香菇
zxiagu=峡谷
zxugou=虚构
zxiangge=相隔
zxianguo=鲜果
zxigai=膝盖
zxiaguang=霞光
zxuegao=雪糕
zxiongguan=雄关
zxunguo=殉国
zxiangui=显贵
zxianguan=县官
zxianguang=闲逛
zxiaogui=校规
zxiegong=歇工
zxinjiang=新疆
zxiangjiao=橡胶
zxianjie=衔接
zxiaoji=消极
zxiaji=夏季
zxujia=虚假
zxiji=袭击
zxuejian=削减
zxijun=细菌
zxiangjiao=香蕉
zxingjing=刑警
zxiangju=相距
zxiangjin=详尽
zxiangjiang=湘江
zxiejue=谢绝
zxijuan=席卷
zxinjin=薪金
zxingjing=行径
zxinjing=心境
zxiju=喜剧
zxiaojia=削价
zxunji=迅即
zxuanjiang=宣讲
zxiongjin=胸襟
zxujiu=酗酒
zxiji=希冀
zxijian=席间
zxuejiang=血浆
zxiangjing=香精
zxujian=续建
zxujiu=许久
zxuanji=旋即
zxianjing=陷阱
zxiujian=修剪
zxianjing=仙境
zxianjun=险峻
zxiaojing=孝敬
zxianji=献计
zxiujue=嗅觉
zxijie=洗劫
zxunjue=勋爵
zxunjie=迅捷
zxueji=血迹
zxuji=续集
zxianjing=险境
zxueji=学籍
zxiaojie=消解
zxinji=心悸
zxiongjian=雄健
zxinji=心迹
zxiaojiang=骁将
zxunji=迅疾
zxiejiao=歇脚
zxinjian=信笺
zxunjie=训诫
zxujing=虚惊
zxuejia=雪茄
zxiejiang=鞋匠
zxijiao=犀角
zxijiu=喜酒
zxueju=穴居
zxiangjie=详解
zxijiu=细究
zxingju=刑具
zxuanji=玄机
zxianjing=娴静
zxujiu=叙旧
zxingji=形迹
zxijian=溪涧
zxianjie=仙界
zxiejin=泄劲
zxujia=续假
zxiajian=下贱
zxiaji=狎妓
zxinku=辛苦
zxingkui=幸亏
zxiankai=掀开
zxiukou=袖口
zxinkan=心坎
zxuankong=悬空
zxiukui=羞愧
zxiake=侠客
zxiankuang=现况
zxukua=虚夸
zxike=稀客
zxiamen=厦门
zxianming=鲜明
zxunmeng=迅猛
zxiaomie=消灭
zxumu=畜牧
zxumu=序幕
zxingmu=醒目
zxianmu=羡慕
zxiongmao=熊猫
zxunmi=寻觅
zxiemao=鞋帽
zxiongmei=兄妹
zxianmei=鲜美
zximie=熄灭
zxuemai=血脉
zxingmian=幸免
zxiemi=泄密
zxuming=虚名
zxiangmao=相貌
zximi=细密
zxiaomo=消磨
zxingmao=形貌
zxiumian=休眠
zxiami=虾米
zxiemian=斜面
zxuanmiao=玄妙
zxiemu=谢幕
zxianming=贤明
zxiumu=朽木
zxingma=形码
zxuanmu=炫目
zxiaoming=效命
zxianmei=献媚
zxumou=蓄谋
zxinpian=芯片
zxiangpei=相配
zxuanpan=宣判
zxuanpin=选聘
zxiupei=修配
zxingpian=行骗
zxiangpi=橡皮
zxiepo=胁迫
zxiepo=斜坡
zxiongpu=胸脯
zxupian=续篇
zxupei=许配
zxingqu=兴趣
zxianqi=掀起
zxinqin=辛勤
zxiaqu=辖区
zxiangqian=镶嵌
zxiqing=喜庆
zxianquan=线圈
zxianqing=险情
zxunqi=汛期
zxianqu=先驱
zxiaoqian=消遣
zxuqu=序曲
zxunqing=汛情
zxianqian=先遣
zxiangqing=详情
zxingqi=刑期
zxiqi=稀奇
zxiaoqi=小憩
zxianqi=嫌弃
zxieqi=泄气
zxiuqi=修葺
zxiongqiang=胸腔
zxiqi=喜气
zxique=喜鹊
zxueqiao=雪橇
zxingqie=行窃
zxiuqie=羞怯
zxunqing=殉情
zxingqi=腥气
zxiqi=希奇
zxunqing=徇情
zxiqu=袭取
zxingshi=形式
zxingshi=形势
zxunsu=迅速
zxiangshou=享受
zxingshi=刑事
zxisheng=牺牲
zxiaoshi=消失
zxinshang=欣赏
zxingshi=行驶
zxiaosa=潇洒
zxianshen=献身
zxingshu=行署
zxiansuo=线索
zxieshou=携手
zxiaoshe=校舍
zxushu=叙述
zxushui=蓄水
zxingshuai=兴衰
zxuanshu=悬殊
zxiangshi=相识
zxueshi=学识
zxieshi=谢世
zxiushan=修缮
zxishao=稀少
zxuanshi=宣誓
zxunshi=巡视
zxiansan=闲散
zxueshi=学士
zxingsheng=兴盛
zxiangshi=翔实
zxueshuan=血栓
zxishi=稀释
zxishui=溪水
zxianshu=娴熟
zxiuse=羞涩
zxushi=叙事
zxinsuan=辛酸
zxishi=喜事
zxinshui=薪水
zxingsi=形似
zxiashou=夏收
zxunse=逊色
zxiaoshou=消瘦
zxishou=洗手
zxishuai=蟋蟀
zxushi=虚实
zxiushi=修饰
zxishi=吸食
zxishu=稀疏
zxushe=虚设
zxiaosan=消散
zxishua=洗刷
zxianshi=闲事
zxiongshi=熊市
zxiaoshun=孝顺
zxinsuan=心酸
zxiaoshi=消逝
zxiansheng=险胜
zxishu=悉数
zxushuo=叙说
zxuanshang=悬赏
zxingshan=行善
zxiaose=萧瑟
zxishun=吸吮
zxiongshi=雄师
zxieshi=斜视
zxingshi=幸事
zxiasi=遐思
zxise=喜色
zxushu=虚数
zxishu=洗漱
zxianshi=仙逝
zxisui=细碎
zxingshen=幸甚
zxunsi=徇私
zxiongsao=兄嫂
zxiaoshou=消受
zxianshu=贤淑
zxusui=虚岁
zxisong=稀松
zxishua=戏耍
zxiaosuo=萧索
zxuansun=玄孙
zxingsao=腥臊
zxunshun=驯顺
zxingtai=形态
zxintuo=信托
zxintai=心态
zxiatian=夏天
zxingti=形体
zxiaotiao=萧条
zxuntao=熏陶
zxinteng=心疼
zxuetu=学徒
zxintu=信徒
zxuetang=学堂
zxiangtian=香甜
zxuetang=血糖
zxiaotui=消退
zxiantan=险滩
zxiantan=闲谈
zxietong=偕同
zxutan=叙谈
zxutuo=虚脱
zxitang=喜糖
zxiangtan=详谈
zxituo=洗脱
zxiwang=希望
zxianwei=县委
zxianwei=纤维
zxingwang=兴旺
zxinwei=欣慰
zxiwei=席位
zxiangwei=香味
zxiongwei=雄伟
zxuewei=穴位
zxiaowang=消亡
zxingwu=醒悟
zxuwei=虚伪
zxuanwo=漩涡
zxiewa=鞋袜
zxuwu=虚无
zxiewen=斜纹
zxingwang=兴亡
zxinwo=心窝
zxiongwei=胸围
zxuwen=序文
zxuwang=虚妄
zxiwen=檄文
zxiawa=夏娃
zxingwu=省悟
zxuwen=虚文
zxinxi=信息
zxingxiang=形象
zxiaoxi=消息
zxinxing=新型
zxiuxi=休息
zxiangxi=详细
zxinxian=新鲜
zxinxi=欣喜
zxiuxian=休闲
zxiexie=谢谢
zxianxue=鲜血
zxixun=喜讯
zxiaxiao=狭小
zxinxiang=信箱
zxianxue=献血
zxuxin=虚心
zxuxu=徐徐
zxixin=悉心
zxixia=西夏
zxianxia=闲暇
zxuanxiao=喧嚣
zxiongxin=雄心
zxiongxiong=熊熊
zxiaoxian=消闲
zxianxie=险些
zxuexing=血型
zxiexu=些许
zxiongxing=雄性
zxixi=嬉戏
zxingxun=刑讯
zxiaxiang=遐想
zxuexing=血腥
zxinxian=心弦
zxinxu=心绪
zxuxian=虚线
zxuanxie=宣泄
zxiaoxin=孝心
zxianxian=先贤
zxianxi=纤细
zxiangxing=象形
zxixia=膝下
zxinxiang=馨香
zxiexi=歇息
zxunxin=寻衅
zxianxing=现形
zxixue=戏谑
zxiongxian=凶险
zxianxian=纤纤
zxuanxue=玄学
zxianxin=闲心
zxingxing=猩猩
zxiexian=斜线
zxinxu=心虚
zxuxian=续弦
zxuanxu=玄虚
zxuexi=血洗
zxiuxiang=绣像
zxiaoxiong=枭雄
zxuxi=嘘唏
zxiexue=谐谑
zxianxi=嫌隙
zxiaxi=罅隙
zxiaoyi=效益
zxieyi=协议
zxiaoying=效应
zxinyu=信誉
zxiangyou=享有
zxinying=新颖
zxueye=血液
zxuanyan=宣言
zxiyue=喜悦
zxinyang=信仰
zxianyang=咸阳
zxingyun=幸运
zxianyan=鲜艳
zxiangyu=享誉
zxianyi=现役
zxuanyang=宣扬
zxianyu=陷于
zxingyi=行医
zxiongyong=汹涌
zxiaoyan=硝烟
zxueyuan=血缘
zxiyi=西医
zxiyou=稀有
zxieyi=谢意
zxiangyong=享用
zxianyi=嫌疑
zxiayi=狭义
zxuanyao=炫耀
zxuanya=悬崖
zxuyi=蓄意
zxiaoyong=效用
zxiyu=西域
zxieye=歇业
zxuyu=絮语
zxiongying=雄鹰
zxuyan=序言
zxianyi=献艺
zxiaoyan=消炎
zxieyin=谐音
zxuyu=须臾
zxunyang=驯养
zxiangyi=相宜
zxiaoyao=逍遥
zxiyu=洗浴
zxianyao=险要
zxieyang=斜阳
zxieyou=鞋油
zxiaoyan=笑颜
zxiaoyi=校医
zxiayi=侠义
zxuyuan=许愿
zxiaoyong=骁勇
zxiaoye=笑靥
zxunyou=巡游
zxuyang=畜养
zxiyan=喜宴
zxiyong=袭用
zxieyao=泻药
zxuyang=蓄养
zxiuyi=秀逸
zxiaoyan=效验
zxiyi=蜥蜴
zxiangyan=香艳
zxianyao=显耀
zxuyan=绪言
zxuanze=选择
zxizang=西藏
zxingzhi=性质
zxianzhuang=现状
zxiezhu=协助
zxianchang=县长
zxuzhou=徐州
zxianzhi=闲置
zxingzhuang=形状
zxuanzhuan=旋转
zxinzang=心脏
zxiazhai=狭窄
zxiuzhu=修筑
zxizao=洗澡
zxianzhang=宪章
zxiezhao=写照
zxiezi=鞋子
zxunzhang=勋章
zxiuzhen=袖珍
zxiongzhuang=雄壮
zxiangzao=香皂
zxuanzhan=宣战
zxiongzi=雄姿
zxuanzhi=宣纸
zxiangzi=箱子
zxiangzhu=相助
zxiaozhang=嚣张
zxiuzheng=修整
zxiaozang=销赃
zxingzong=行踪
zxizi=席子
zxiuzi=袖子
zxiuzheng=休整
zxinzhi=新址
zxiazi=匣子
zxianzhi=县志
zxiaochang=消长
zxiangzi=巷子
zxiaozhi=校址
zxiangzhang=像章
zxiaozi=孝子
zxiaozhong=效忠
zxianzhe=先哲
zxiaozhuan=小篆
zxianzu=先祖
zxunzhi=殉职
zxianzu=险阻
zxizhou=稀粥
zxinzhi=信纸
zxiezai=卸载
zxianzhao=先兆
zxiuzhang=袖章
zxuezi=靴子
zxuezhai=血债
zxianza=闲杂
zxinzi=薪资
zxiangzhan=巷战
zxunzang=殉葬
zjiazhi=挟制
zxiezhuang=卸妆
zxianzhi=闲职
zxiongzhai=凶宅
zyanan=延安
zyian=议案
zyanan=沿岸
zyouai=有碍
zyuanan=冤案
zyouan=幽暗
zyian=疑案
zyue=余额
zyinger=婴儿
zyouer=幼儿
zyueer=悦耳
zyouer=诱饵
zyiner=银耳
zyuer=鱼饵
zyiliao=医疗
zyule=娱乐
zyinliao=饮料
zyulun=舆论
zyingli=盈利
zyilai=依赖
zyanli=严厉
zyilun=议论
zyouru=犹如
zyunian=余年
zyiran=毅然
zyinran=印染
zyelian=冶炼
zyilang=伊朗
zyoulan=游览
zyoulv=忧虑
zyunniang=酝酿
zyouren=游人
zyuliao=预料
zyiliu=遗留
zyouren=诱人
zyurong=羽绒
zyilv=疑虑
zyili=毅力
zyingli=赢利
zyaoling=要领
zyaolan=摇篮
zyueliang=月亮
zyinan=疑难
zyulan=玉兰
zyangrou=羊肉
zyoulie=优劣
zyiren=艺人
zyuling=育龄
zyoule=游乐
zyili=屹立
zyiren=宜人
zyouli=游离
zyuanren=猿人
zyure=余热
zyurou=鱼肉
zyanliao=颜料
zyanran=俨然
zyounian=幼年
zyanlian=演练
zyingrao=萦绕
zyangliu=杨柳
zyuanliang=原谅
zyuliu=预留
zyoulao=有劳
zyanlu=沿路
zyinglian=楹联
zyinni=隐匿
zyiri=翌日
zyueli=阅历
zyuni=淤泥
zyouling=幽灵
zyouran=悠然
zyuliang=余粮
zyunnuo=允诺
zyinglie=英烈
zyilian=依恋
zyanlian=眼帘
zyulu=雨露
zyunlv=韵律
zyulin=育林
zyilou=遗漏
zyulei=鱼雷
zyinliang=音量
zyiling=衣领
zyeren=野人
zyinglang=硬朗
zyuli=余力
zyuanlv=远虑
zyunluo=陨落
zyouni=油腻
zyuelan=阅览
zyunong=愚弄
zyuanrun=圆润
zyirong=遗容
zyinliang=阴凉
zyounv=幼女
zyeniu=野牛
zyinling=引领
zyiran=怡然
zyueran=跃然
zyirong=仪容
zyaorao=妖娆
zyouliang=油亮
zyili=迤逦
zyaling=哑铃
zyinglei=营垒
zyinluan=淫乱
zyongren=佣人
zyanluo=阎罗
zyinliang=银两
zyingnuo=应诺
zyouni=油泥
zyaran=哑然
zyuelve=约略
zyinni=印泥
zyonglu=庸碌
zyaoran=杳然
zyilei=异类
zyirang=揖让
zyuanou=怨偶
zyibiao=仪表
zyubao=预报
zyubei=预备
zyanbian=演变
zyingbang=英镑
zyangban=样板
zyuebing=月饼
zyinbi=隐蔽
zyaobao=腰包
zyongbao=拥抱
zyingbin=迎宾
zyuanbao=元宝
zyuanbo=渊博
zyingbi=硬币
zyaobu=腰部
zyiben=译本
zyaobai=摇摆
zyanbo=演播
zyinbao=引爆
zyuebing=阅兵
zyibu=异步
zyinbai=银白
zyaba=哑巴
zyangbian=扬鞭
zyongbing=用兵
zyongbie=永别
zyoubiao=游标
zyaoban=腰板
zyinbi=银币
zyoubu=诱捕
zyanbi=掩蔽
zyoubing=油饼
zyubo=余波
zyoubang=友邦
zyibo=衣钵
zyinbiao=音标
zyoubu=油布
zyuanbing=援兵
zyubu=雨布
zyubo=预卜
zyuben=愚笨
zyuba=渔霸
zyunbin=云鬓
zyanchu=演出
zyuce=预测
zyanchang=延长
zyichang=异常
zyichang=宜昌
zyichan=遗产
zyaocai=药材
zyanchang=演唱
zyicheng=议程
zyingcun=英寸
zyichuan=遗传
zyuncang=蕴藏
zyangcheng=羊城
zyancheng=严惩
zyuchuan=渔船
zyinchuan=银川
zyuancheng=远程
zyicai=异彩
zyouchuan=游船
zyuchang=渔场
zyecai=野菜
zyachi=牙齿
zyanchen=烟尘
zyunchou=运筹
zyongcan=用餐
zyincang=隐藏
zyingchou=应酬
zyingchun=迎春
zyouce=右侧
zyucun=渔村
zyanchi=延迟
zyingchi=英尺
zyancong=烟囱
zyuecai=粤菜
zyichu=益处
zyichu=溢出
zyouchang=悠长
zyanci=言辞
zyecao=野草
zyingchen=映衬
zyongcun=永存
zyuchi=浴池
zyuchang=浴场
zyuchi=鱼翅
zyuchun=愚蠢
zyangcong=洋葱
zyouchou=忧愁
zyinchang=吟唱
zyouchong=幼虫
zyingchu=映出
zyouchuo=邮戳
zyachong=蚜虫
zyecan=野餐
zyingcheng=硬撑
zyuncai=云彩
zyoucai=油彩
zyaochuan=谣传
zyechui=野炊
zyecan=夜餐
zyongcai=庸才
zyaochi=瑶池
zyichong=益虫
zyice=臆测
zyancang=掩藏
zyuanchou=冤仇
zyecha=夜叉
zyachen=牙碜
zyingde=赢得
zyidong=移动
zyuedu=阅读
zyuedan=约旦
zyuandan=元旦
zyuding=预定
zyide=异地
zyudi=余地
zyongdong=涌动
zyoudao=诱导
zyide=医德
zyaodong=窑洞
zyuding=预订
zyuanding=园丁
zyaodai=腰带
zyandu=研读
zyidian=疑点
zyadian=雅典
zyiding=议定
zyoudong=游动
zyindu=引渡
zyongdai=拥戴
zyindiao=音调
zyandian=唁电
zyadan=鸭蛋
zyaodong=摇动
zyoudang=游荡
zyaodian=药典
zyundou=熨斗
zyandong=岩洞
zyedi=野地
zyoudi=邮递
zyiduan=异端
zyunduan=云端
zyudi=雨滴
zyongdao=甬道
zyandi=烟蒂
zyandai=烟袋
zyudun=愚钝
zyidu=遗毒
zyindang=淫荡
zyudu=余毒
zyiduan=臆断
zyinhang=银行
zyanhai=沿海
zyouhui=优惠
zyihui=议会
zyufang=预防
zyanghua=氧化
zyihan=遗憾
zyingfu=应付
zyonghu=拥护
zyinhuan=隐患
zyouhuo=诱惑
zyanhui=宴会
zyinhui=淫秽
zyufou=与否
zyongheng=永恒
zyehua=液化
zyoufa=诱发
zyihu=医护
zyanhua=演化
zyanghu=养护
zyouhuan=忧患
zyanhou=咽喉
zyunhan=蕴含
zyanghuo=洋货
zyinghe=迎合
zyifu=依附
zyinhe=银河
zyuhang=宇航
zyufu=预付
zyouhou=优厚
zyanhu=掩护
zyihuo=疑惑
zyunfu=孕妇
zyanhuan=延缓
zyinghua=樱花
zyaohe=吆喝
zyangfan=扬帆
zyinfu=音符
zyihuo=抑或
zyuhui=迂回
zyuanhang=远航
zyuhan=御寒
zyingfeng=迎风
zyouhao=油耗
zyuefu=岳父
zyihua=异化
zyaofan=要饭
zyanhuo=焰火
zyouhei=黝黑
zyaohuang=摇晃
zyinghao=英豪
zyinghou=迎候
zyanfan=厌烦
zyuanhu=圆弧
zyinhui=银灰
zyuhui=语汇
zyuanhen=怨恨
zyehua=野花
zyifa=益发
zyuanfen=缘分
zyanhong=殷红
zyunhan=蕴涵
zyihen=遗恨
zyaofan=要犯
zyihai=贻害
zyouhui=邮汇
zyanfen=盐分
zyinghun=英魂
zyafeng=牙缝
zyinhui=隐讳
zyuanhun=冤魂
zyinfu=隐伏
zyehuo=野火
zyuanhuan=圆环
zyuanhua=圆滑
zyinghai=婴孩
zyuhuo=渔火
zyinhen=饮恨
zyufu=迂腐
zyufu=渔夫
zyouhui=幽会
zyuhua=羽化
zyoufen=忧愤
zyinhui=隐晦
zyinhun=阴魂
zyifu=姨父
zyanhan=唁函
zyinhun=银婚
zyuanhou=猿猴
zyahuan=丫鬟
zyanfu=艳福
zyinfu=淫妇
zyuanhuang=圆谎
zyinhen=阴狠
zyouhun=游魂
zyange=严格
zyuangao=原告
zyonggan=勇敢
zyiguo=异国
zyangai=掩盖
zyagao=牙膏
zyingen=银根
zyuangu=缘故
zyangge=秧歌
zyigu=已故
zyingguang=荧光
zyugang=渔港
zyingu=因故
zyuangao=原稿
zyugan=预感
zyugao=预告
zyuegao=约稿
zyange=沿革
zyaogan=腰杆
zyugu=预估
zyaogun=摇滚
zyuange=远隔
zyugou=预购
zyigui=衣柜
zyaogu=腰鼓
zyugang=浴缸
zyuguan=鱼贯
zyougu=幽谷
zyanggao=羊羔
zyaogao=药膏
zyigu=遗孤
zyingou=阴沟
zyugang=鱼缸
zyegou=野狗
zyange=阉割
zyouguang=游逛
zyougou=油垢
zyanggong=佯攻
zyonggong=佣工
zyuangui=圆规
zyouguai=诱拐
zyaogong=邀功
zyagou=牙垢
zyanjiu=研究
zyuji=预计
zyejin=冶金
zyingjie=迎接
zyanjun=严峻
zyeji=业绩
zyanjiang=沿江
zyoujiu=悠久
zyanjing=眼镜
zyanjiang=演讲
zyanjin=严谨
zyongjiu=永久
zyujian=预见
zyongji=拥挤
zyouji=游击
zyijiao=移交
zyuejin=跃进
zyueju=跃居
zyanjie=眼界
zyongjin=佣金
zyijing=意境
zyiji=遗迹
zyejing=液晶
zyujing=预警
zyuji=淤积
zyijia=议价
zyinjiu=饮酒
zyuju=豫剧
zyouji=邮寄
zyoujing=油井
zyaojue=要诀
zyiju=移居
zyanjie=沿街
zyouji=游记
zyuanji=原籍
zyuanjian=援建
zyejie=业界
zyingjun=英俊
zyueju=粤剧
zyanjin=演进
zyoujiao=幼教
zyaju=哑剧
zyoujing=幽静
zyangji=殃及
zyujin=浴巾
zyanjuan=厌倦
zyanji=演技
zyinjie=音节
zyuejie=越界
zyanjiang=岩浆
zyinjian=引荐
zyinjian=印鉴
zyuanjia=冤家
zyujia=渔家
zyijin=衣襟
zyinjing=阴茎
zyuejing=越境
zyaoji=邀集
zyuanji=圆寂
zyeji=野鸡
zyuanjiu=援救
zyuejuan=阅卷
zyanjian=眼睑
zyongjue=永诀
zyaojing=妖精
zyinjie=音阶
zyingji=迎击
zyujie=郁结
zyaojin=要津
zyinjian=殷鉴
zyunjue=晕厥
zyoujin=幽禁
zyuga=瑜伽
zyuanjun=援军
zyouju=幽居
zyuji=郁积
zyejian=谒见
zyoujian=诱奸
zyinjiu=引咎
zyunjiao=韵脚
zyouke=游客
zyaokong=遥控
zyingkui=盈亏
zyanku=严酷
zyingkao=应考
zyankuang=眼眶
zyukuan=余款
zyukao=预考
zyanke=宴客
zyikao=倚靠
zyimin=移民
zyuanman=圆满
zyangmao=羊毛
zyanmi=严密
zyumin=渔民
zyanmei=淹没
zyoumo=幽默
zyimian=以免
zyimiao=疫苗
zyumiao=育苗
zyinmu=银幕
zyinman=隐瞒
zyumei=愚昧
zyumao=羽毛
zyemu=夜幕
zyinmou=阴谋
zyingmian=迎面
zyingmo=英模
zyumiao=鱼苗
zyoumo=油墨
zyeman=野蛮
zyanmai=掩埋
zyoumu=游牧
zyema=野马
zyoumiao=幼苗
zyema=页码
zyamen=衙门
zyuanmao=原貌
zyanmo=研磨
zyunmu=韵母
zyangmiao=秧苗
zyangmu=仰慕
zyongmeng=勇猛
zyumou=预谋
zyuemu=岳母
zyanmei=湮没
zyuanmeng=圆梦
zyangmei=杨梅
zyiming=译名
zyinmai=阴霾
zyiming=艺名
zyuemu=悦目
zyanmian=颜面
zyumen=郁闷
zyoumin=游民
zyangmian=仰面
zyanmai=燕麦
zyanmie=湮灭
zyanmu=烟幕
zyanming=验明
zyemang=夜盲
zyiming=佚名
zyouming=幽冥
zyumin=愚民
zyuming=域名
zyami=哑谜
zyinma=音码
zyemao=腋毛
zyaopin=药品
zyongpin=用品
zyangpin=样品
zyinpai=银牌
zyapo=压迫
zyingpin=应聘
zyingping=荧屏
zyapian=鸦片
zyinpin=音频
zyoupian=诱骗
zyanpin=赝品
zyuepu=乐谱
zyupen=浴盆
zyinping=银屏
zyaopu=药铺
zyuanpu=园圃
zyupei=玉佩
zyingpin=硬拼
zyaoqing=邀请
zyiqi=仪器
zyouqi=尤其
zyuqi=预期
zyongqi=勇气
zyuqi=逾期
zyouqu=有趣
zyuanquan=源泉
zyanqing=宴请
zyouqi=油漆
zyinqie=殷切
zyangqi=氧气
zyanqi=延期
zyiqing=疫情
zyiqi=遗弃
zyouqing=右倾
zyinqing=引擎
zyuanquan=圆圈
zyangqi=扬弃
zyuanqi=怨气
zyaqian=牙签
zyanquan=眼圈
zyinqin=殷勤
zyunque=云雀
zyiqu=意趣
zyanqing=艳情
zyingqin=迎亲
zyuanqu=冤屈
zyuanqiu=圆球
zyaqu=雅趣
zyinqin=姻亲
zyingqu=迎娶
zyingquan=鹰犬
zyuanqing=冤情
zyinqi=饮泣
zyishu=艺术
zyunshu=运输
zyinsu=因素
zyishi=意识
zyusuan=预算
zyisheng=医生
zyinshua=印刷
zyansu=严肃
zyishi=仪式
zyaosu=要素
zyueshu=约束
zyinshi=饮食
zyanshou=验收
zyesheng=野生
zyasuo=压缩
zyanshen=延伸
zyanse=颜色
zyuanshi=院士
zyingshi=影视
zyuansu=元素
zyanshi=岩石
zyinshui=饮水
zyaoshi=钥匙
zyanshi=演示
zyuanshuai=元帅
zyushi=预示
zyongsu=庸俗
zyishu=医术
zyongshi=勇士
zyusai=预赛
zyanshuo=演说
zyisong=移送
zyushi=浴室
zyunshi=陨石
zyanshui=盐水
zyanshi=掩饰
zyingshi=应试
zyongsheng=永生
zyansheng=衍生
zyishi=衣食
zyoushui=游说
zyinsi=隐私
zyashua=牙刷
zyushen=预审
zyishang=衣裳
zyishan=衣衫
zyishi=遗失
zyinsu=音速
zyinse=音色
zyusan=雨伞
zyingshe=映射
zyishu=遗书
zyingsu=罂粟
zyeshou=野兽
zyoushan=友善
zyoushang=忧伤
zyusuo=寓所
zyaosai=要塞
zyingsong=迎送
zyoushi=诱使
zyinshen=引申
zyinshi=殷实
zyushu=榆树
zyoushen=幽深
zyaoshan=药膳
zyusai=淤塞
zyoushi=幼时
zyangshi=仰视
zyinshi=吟诗
zyishuang=遗孀
zyongshi=永世
zyinsong=吟诵
zyinsen=阴森
zyinshu=引述
zyeshi=野史
zyusai=语塞
zyaoshen=腰身
zyinshi=隐士
zyuanshou=援手
zyousha=诱杀
zyishi=逸事
zyansuan=验算
zyinshu=淫书
zyangsan=阳伞
zyongsai=拥塞
zyangshui=羊水
zyunsu=匀速
zyushu=余数
zyuansou=渊薮
zyanshi=厌世
zyueshi=月食
zyanshu=眼熟
zyuanshu=圆熟
zyeshu=页数
zyunse=愠色
zyongsai=壅塞
zyangshou=阳寿
zyituo=依托
zyongtu=用途
zyantao=研讨
zyiti=遗体
zyeti=液体
zyiti=议题
zyaotou=摇头
zyantu=沿途
zyutang=鱼塘
zyingtao=樱桃
zyouting=游艇
zyuantiao=远眺
zyingtan=影坛
zyetai=液态
zyitong=异同
zyingtou=蝇头
zyaotiao=窈窕
zyanti=掩体
zyoutong=幼童
zyitai=仪态
zyongtan=咏叹
zyetu=野兔
zyoutong=邮筒
zyantong=烟筒
zyantai=砚台
zyituan=疑团
zyunti=云梯
zyutu=玉兔
zyintang=印堂
zyuantong=圆通
zyingting=英挺
zyouwei=尤为
zyiwu=医务
zyiwen=疑问
zyewai=野外
zyiwei=意味
zyanwu=延误
zyunwei=韵味
zyanwu=烟雾
zyiwang=遗忘
zyouwu=油污
zyiwu=遗物
zyiwu=贻误
zyiwen=译文
zyunwu=云雾
zyiwei=异味
zyouwan=游玩
zyanwu=厌恶
zyuanwang=冤枉
zyewei=野味
zyangwang=仰望
zyanwo=燕窝
zyuanwai=援外
zyiwu=异物
zyingwu=鹦鹉
zyuwai=域外
zyongwu=用武
zyanwang=阎王
zyangwo=仰卧
zyinwei=淫威
zyingwu=英武
zyangwei=阳痿
zyiwei=依偎
zyanwo=眼窝
zyuweng=渔翁
zyaowan=药丸
zyaowei=腰围
zyewo=腋窝
zyunwen=韵文
zyiwen=逸闻
zyuwan=愚顽
zyouxiao=有效
zyunxu=允许
zyixue=医学
zyingxiong=英雄
zyongxian=涌现
zyouxu=有序
zyinxiang=音像
zyouxi=游戏
zyanxian=沿线
zyinxiang=音响
zyanxu=延续
zyouxing=有形
zyanxi=演习
zyouxing=有幸
zyouxing=游行
zyinxing=隐形
zyuxian=预先
zyinxing=银杏
zyuanxing=原型
zyuanxing=圆形
zyanxi=沿袭
zyuxia=鱼虾
zyixing=异性
zyouxiang=油箱
zyixi=议席
zyuexin=月薪
zyuxia=余下
zyaoxiao=药效
zyanxi=宴席
zyingxin=迎新
zyouxiao=幼小
zyuxian=遇险
zyanxi=筵席
zyuxiang=预想
zyanxi=演戏
zyunxia=云霞
zyixiang=遗像
zyixi=依稀
zyouxian=悠闲
zyixiang=异乡
zyanxia=炎夏
zyexin=野心
zyinxun=音讯
zyuxuan=预选
zyanxi=研习
zyuxi=玉玺
zyuanxing=原形
zyanxing=严刑
zyuanxin=圆心
zyinxiang=音箱
zyouxiang=幽香
zyaoxie=要挟
zyexia=腋下
zyaoxiang=药箱
zyixin=疑心
zyuxia=余暇
zyinxin=音信
zyexing=野性
zyuexi=月息
zyuanxun=元勋
zyinxian=阴险
zyixiu=衣袖
zyuxi=预习
zyuxie=淤血
zyixiang=臆想
zyixun=遗训
zyouxiang=邮箱
zyanxue=验血
zyunxuan=晕眩
zyuxing=余兴
zyouxia=游侠
zyuxie=雨鞋
zyiyuan=医院
zyongyou=拥有
zyiyao=医药
zyuyi=予以
zyinyue=音乐
zyongyuan=永远
zyouyi=友谊
zyanyuan=演员
zyuye=渔业
zyouyi=有益
zyeyu=业余
zyouyong=游泳
zyongyu=勇于
zyingyao=应邀
zyinyong=饮用
zyiyuan=议员
zyouyi=优异
zyongyue=踊跃
zyingyong=英勇
zyunyu=孕育
zyeye=爷爷
zyuyin=语音
zyuyan=预言
zyangyi=洋溢
zyiyi=异议
zyuyan=寓言
zyaoyan=耀眼
zyuanyi=园艺
zyayi=压抑
zyouyu=犹豫
zyanyong=沿用
zyingyu=盈余
zyangyu=养育
zyueye=越野
zyouyou=悠悠
zyouyuan=游园
zyuanyan=怨言
zyanyi=演义
zyuanyuan=渊源
zyuanyou=缘由
zyuyue=预约
zyouyi=游艺
zyuyi=寓意
zyinyou=引诱
zyuyue=愉悦
zyuanyin=援引
zyanying=掩映
zyiyuan=艺苑
zyinyu=饮誉
zyuanye=原野
zyaoyan=谣言
zyouya=幽雅
zyanyi=演艺
zyanyi=演绎
zyuanyang=鸳鸯
zyouyang=悠扬
zyouyi=右翼
zyouyu=忧郁
zyaoye=摇曳
zyouyuan=有缘
zyiyu=抑郁
zyiyun=意蕴
zyanyu=谚语
zyiyuan=遗愿
zyinyin=殷殷
zyangyong=仰泳
zyinyuan=银元
zyuyi=羽翼
zyuanyin=元音
zyuyue=逾越
zyuyu=寓于
zyiyu=异域
zyiyang=异样
zyouyuan=悠远
zyingyan=应验
zyinyi=音译
zyueyu=越狱
zyiyan=遗言
zyanyang=艳阳
zyouyu=优裕
zyinyong=吟咏
zyinyuan=姻缘
zyeying=野营
zyaoye=药液
zyuyong=御用
zyeying=夜莺
zyanyin=烟瘾
zyinyu=音域
zyinyu=隐喻
zyuyan=预演
zyiyin=译音
zyouyi=犹疑
zyouyuan=幽远
zyuanyu=冤狱
zyiyou=益友
zyiyun=疑云
zyangyang=痒痒
zyaoyue=邀约
zyangyang=怏怏
zyinyuan=因缘
zyayun=押韵
zyuying=育婴
zyinyu=阴郁
zyiye=肄业
zyuanyong=援用
zyaoyan=妖艳
zyiyu=呓语
zyouyuan=幽怨
zyaoye=妖冶
zyayi=衙役
zyanzhi=研制
zyazhou=亚洲
zyouzhi=优质
zyangzhi=养殖
zyizhao=依照
zyizhi=抑制
zyuanzhu=援助
zyanzhe=沿着
zyizhi=遗址
zyizhi=移植
zyanzheng=验证
zyangzhou=扬州
zyichang=议长
zyanzou=演奏
zyuzhou=宇宙
zyouzhong=由衷
zyizhi=医治
zyuezhang=乐章
zyinzhang=印章
zyezi=椰子
zyizu=彝族
zyingzhang=硬仗
zyouzhi=幼稚
zyizi=椅子
zyizhu=遗嘱
zyuanzhu=圆柱
zyingzi=英姿
zyingzhan=迎战
zyuanzhuang=原状
zyaozu=瑶族
zyaozhe=夭折
zyazi=鸭子
zyouzi=游子
zyongzhong=臃肿
zyinzhi=音质
zyuzhu=预祝
zyanzheng=炎症
zyingzhao=映照
zyezhan=野战
zyizhe=译者
zyizhu=译著
zyuanzhi=原址
zyanzhi=胭脂
zyazha=压榨
zyuanzhui=圆锥
zyizhan=驿站
zyongzhuang=泳装
zyizhi=遗志
zyizhang=依仗
zyuzhi=预知
zyezhu=野猪
zyuanzhou=圆周
zyanzheng=严整
zyinzi=银子
zyizhu=医嘱
zyuanzhuo=圆桌
zyouzi=幼子
zyuzhao=预兆
zyizhong=倚重
zyunzhi=韵致
zyizhang=仪仗
zyouzi=油渍
zyangzhuang=佯装
zyizhang=倚仗
zyanzhan=延展
zyuezhong=月终
zyaozi=腰子
zyuzhi=预支
zyuzhuo=玉镯
zyanzhan=厌战
zyuzhao=玉照
zyizao=臆造
zyuanzu=远祖
zyaozhu=遥祝
zyouzi=犹自
zyingzhang=营帐
zyaozhan=腰斩
zyuezhang=岳丈
zyuzu=狱卒
zzhangai=障碍
zzuai=阻碍
zzhongai=钟爱
zzhiai=致癌
zzuian=罪案
zzuie=罪恶
zzuoe=作恶
zzue=阻遏
zzaie=灾厄
zzhiliang=质量
zzeren=责任
zzhanlve=战略
zzhiliao=治疗
zzulin=租赁
zzhanlan=展览
zzhanling=占领
zzeling=责令
zzhili=智力
zzhunian=逐年
zzhengli=整理
zzhurou=猪肉
zzhineng=智能
zzhongliu=肿瘤
zzilv=自律
zzhuli=助理
zzuli=阻力
zzhuanlan=专栏
zzoulang=走廊
zzhili=智利
zzhongren=众人
zzunao=阻挠
zzhenrong=阵容
zzhuangli=壮丽
zzhongnian=终年
zzhouran=骤然
zzhaolai=招徕
zzhaoliao=照料
zzheli=哲理
zzuren=族人
zzhiliu=滞留
zzhulin=竹林
zzirun=滋润
zzongrong=纵容
zzhenliao=诊疗
zzhongri=终日
zzhuanglie=壮烈
zzhelu=着陆
zzhaolan=招揽
zshanlan=栅栏
zzhaoliang=照亮
zzheren=哲人
zzonglv=棕榈
zzangli=葬礼
zzulan=阻拦
zzhuli=伫立
zzhinen=稚嫩
zzhaoli=照例
zzhengliu=蒸馏
zzhuiluo=坠落
zzenan=责难
zzhengrong=整容
zzhailu=摘录
zzhinang=智囊
zzhongle=终了
zzhulian=株连
zzhuangnian=壮年
zzuiren=罪人
zzuolao=坐牢
zzhinv=侄女
zzhenglong=蒸笼
zzhuri=逐日
zzhanlan=湛蓝
zzhengrong=峥嵘
zzhonglou=钟楼
zzhuore=灼热
zzhuoran=卓然
zzalan=砸烂
zzhanlu=展露
zzhongliang=忠良
zzhuru=侏儒
zzhiniu=执拗
zziran=自燃
zzonglan=纵览
zzhanran=沾染
zzhuona=捉拿
zzhaoli=照理
zzangluan=脏乱
zzhengning=狰狞
zzhuolie=拙劣
zzhuonong=捉弄
zzhinv=织女
zzhulan=竹篮
zzhuran=助燃
zzhengnian=整年
zzanliang=咱俩
zzhaoliang=着凉
zzhangnao=樟脑
zzhouli=妯娌
zchuanlve=传略
zzhonglie=忠烈
zzoulou=走漏
zzhelan=遮拦
zzhaoling=招领
zzuinie=罪孽
zzaoni=枣泥
zzaolian=早恋
zzhaore=招惹
zzunrong=尊容
zzaonan=遭难
zzhennu=震怒
zzennai=怎奈
zzaonie=造孽
zzhanli=战栗
zzirao=滋扰
zzhulou=竹篓
zzuonie=作孽
zzhuoliang=酌量
zzhire=炙热
zzeou=择偶
zzuoou=作呕
zzhubu=逐步
zzhunbei=准备
zzhibiao=指标
zzhaobiao=招标
zzhuangbei=装备
zzuobiao=坐标
zzhubao=珠宝
zzhibei=植被
zzhongbiao=钟表
zzhibei=制备
zzhengbing=征兵
zzhuanbo=转播
zzhibo=直拨
zzhaoban=照搬
zzhibo=直播
zzibu=滋补
zzengbu=增补
zzhuibu=追捕
zzhongbo=中波
zzibei=自备
zzhibiao=治标
zzhanbei=战备
zzhibi=纸币
zzhangbei=长辈
zzhenbao=珍宝
zzhanbai=战败
zzhuangban=装扮
zzibei=自卑
zzhibi=执笔
zzhibian=质变
zzhengba=争霸
zzubei=祖辈
zzebei=责备
zzhaibian=摘编
zzhenbie=甄别
zcangbao=藏胞
zzhengbian=争辩
zzhongbing=重兵
zzhaoban=照办
zzhengbian=整编
zzuobi=作弊
zzuoba=作罢
zzhiban=置办
zzhubei=贮备
zzhanbian=沾边
zzhanbo=展播
zzengbing=增兵
zzhebi=遮蔽
zziba=自拔
zzhenbi=振臂
zzhuban=主板
zzhanbu=占卜
zzhuobu=桌布
zzhaba=眨巴
zzhongbai=钟摆
zzhangbu=账簿
zzhibei=置备
zzhenban=砧板
zzhunbao=准保
zzhengce=政策
zzhongcai=仲裁
zzongcai=总裁
zzhicheng=支撑
zzhicai=制裁
zzhencheng=真诚
zzhangcheng=章程
zzhuancheng=专程
zzancheng=赞成
zzichou=自筹
zzhencha=侦查
zzhongcheng=忠诚
zzhencha=侦察
zzecheng=责成
zzhucun=贮存
zzhucang=贮藏
zzhencang=珍藏
zzhongcan=中餐
zzaocan=早餐
zzhanchi=展翅
zzuoce=左侧
zzhengcheng=征程
zzhaochang=照常
zzuchuan=祖传
zzhongchen=忠臣
zzicai=紫菜
zzhici=致辞
zzhenchan=震颤
zzuncong=遵从
zzhaochao=照抄
zzhaichu=摘除
zzhongchang=终场
zzhangchao=涨潮
zzhuci=祝词
zzuncheng=尊称
zzuocang=座舱
zzhuangche=撞车
zzhuchu=逐出
zzhuchong=蛀虫
zzhacai=榨菜
zzhaichao=摘抄
zzongci=宗祠
zzunchong=尊崇
zzhicheng=至诚
zzhichi=咫尺
zzaocha=早茶
zzhengchen=征尘
zzaocao=早操
zzhongchang=衷肠
zzhencao=贞操
zzhengcan=正餐
zzhence=侦测
zzhengchi=整饬
zzuichan=嘴馋
zzhouche=舟车
zzhichi=指斥
zzhengchong=争宠
zzhongduo=众多
zzhengdun=整顿
zzhuangda=壮大
zzaodao=遭到
zzhenduan=诊断
zzhongduan=终端
zzhendong=震动
zzhongdan=重担
zzhengduan=争端
zzhendong=振动
zzhidi=质地
zzhendang=振荡
zzhongdian=终点
zzudang=阻挡
zzongdu=总督
zzhadan=炸弹
zzhendang=震荡
zzidian=字典
zzhengdang=整党
zzhendi=真谛
zzhedie=折叠
zzhidao=执导
zzuduan=阻断
zzhandao=栈道
zzhedang=遮挡
zzanding=暂定
zzhuidao=追悼
zzhongdian=钟点
zzhuangdan=壮胆
zzhangduo=掌舵
zzuodian=坐垫
zzhengdian=正殿
zzhuangding=壮丁
zzhunding=准定
zzhadao=铡刀
zzhaidi=宅第
zzata=杂沓
zzeda=责打
zzhengfu=政府
zzonghe=综合
zzhifa=执法
zzhihui=指挥
zzhifu=支付
zzhuhe=祝贺
zzhihui=智慧
zzhihou=滞后
zzuifan=罪犯
zzihao=自豪
zzhenfen=振奋
zzifu=字符
zzaofu=造福
zzongheng=纵横
zzhifang=脂肪
zzhanfu=战俘
zzhuanghuang=装潢
zzuofang=作坊
zzhenhan=震撼
zzuofan=做饭
zzhufu=祝福
zzhengfa=蒸发
zzhangfa=章法
zzufu=祖父
zzhihan=致函
zzhufu=嘱咐
zzhenfu=振幅
zzhaohuan=召唤
zzhengfeng=整风
zzuofei=作废
zzhenghe=整合
zzahuo=杂货
zzhuhou=诸侯
zzhufan=主犯
zzhihuan=置换
zzanhuan=暂缓
zzaofan=早饭
zzonghui=总汇
zzhuihui=坠毁
zzhaohe=兆赫
zzongfa=宗法
zzhaohui=照会
zzhihe=纸盒
zzhufeng=主峰
zzhonghou=忠厚
zzhongfeng=中锋
zzhanfan=战犯
zzaihuo=灾祸
zzhihang=直航
zzihong=紫红
zzhaofa=照发
zzhahui=炸毁
zzaihuang=灾荒
zzhanfang=绽放
zzhongfan=重犯
zzenghen=憎恨
zzhuanghuo=装货
zzhanhao=战壕
zzufen=祖坟
zzhuanheng=专横
zzhefu=蛰伏
zzhenghou=症候
zzhanhuo=战祸
zzhaohun=招魂
zzaofeng=遭逢
zzifen=自焚
zzhengfa=征伐
zzhenfei=诊费
zzefa=责罚
zzhaohuo=肇祸
zzhuhou=伫候
zzhengge=整个
zzuguo=祖国
zzige=资格
zzhaogu=照顾
zzhengui=珍贵
zzhenggui=正规
zzhuangguan=壮观
zzhenggai=整改
zzhagen=扎根
zzhuangui=专柜
zzhuigan=追赶
zzhuge=逐个
zzuge=阻隔
zzongguan=综观
zzongguan=纵贯
zzhuangao=转告
zzhonggao=忠告
zzhuangao=撰稿
zzaogao=糟糕
zzange=赞歌
zzeguai=责怪
zzuge=组阁
zzhenggao=征稿
zzhigu=桎梏
zzugao=组稿
zzhonggui=终归
zzhugan=竹竿
zzhigan=质感
zzhegai=遮盖
zzhanggui=掌柜
zzhangu=战鼓
zzuiguo=罪过
zzungui=尊贵
zzhugong=助工
zzaige=宰割
zzhanggu=掌故
zzhaoguan=照管
zzhugong=助攻
zzaguo=砸锅
zzheguang=遮光
zzhenggao=正告
zzuogeng=作梗
zzuigui=醉鬼
zziji=自己
zzhejiang=浙江
zzhujian=逐渐
zzuijia=最佳
zzongjiao=宗教
zzhuijiu=追究
zzhijing=直径
zzhenjing=震惊
zzujin=租金
zzuji=足迹
zzhuangji=撞击
zzhaoji=召集
zzhengji=政绩
zzhongjian=中坚
zzunjing=尊敬
zzhuangjia=庄稼
zzhengji=整机
zzhengjie=整洁
zzhengjie=症结
zzhengjiu=拯救
zzhuangju=壮举
zzhenjiu=针灸
zzhengjie=政界
zzhongjie=终结
zzhuji=逐级
zzhanji=战绩
zzhongjiu=终究
zzaji=杂技
zzhijiao=执教
zzuji=祖籍
zzongjian=总监
zzhongji=终极
zzhangjie=章节
zzhujiao=助教
zzhijing=止境
zzhuangjia=装甲
zzhongjiang=终将
zzhuijiao=追缴
zziji=字迹
zzujie=租借
zzhenjun=真菌
zzhijing=致敬
zzhijia=指甲
zzhaji=札记
zzhouji=洲际
zzhenjing=镇静
zzijian=自荐
zzujie=租界
zzongji=踪迹
zzhijie=肢解
zzuji=阻击
zzhaojian=召见
zzhanjian=战舰
zzhongju=终局
zzhujiu=祝酒
zzhaojiu=照旧
zzuanjie=钻戒
zzanjia=咱家
zzhiji=知己
zzhenji=真迹
zzhenji=赈济
zzhuangjia=庄家
zzhijin=纸巾
zzaojie=遭劫
zzuju=祖居
zzhijie=枝节
zzhouji=周济
zzhenjiu=斟酒
zzanjie=暂借
zzhenji=侦缉
zzhijia=趾甲
zzujie=阻截
zzheju=蛰居
zzhaijie=斋戒
zzhaiji=摘记
zzhuojian=捉奸
zzujue=阻绝
zzhaokai=召开
zzhuangkuang=状况
zzhikong=指控
zzukang=阻抗
zzangkuan=赃款
zzikong=自控
zzhaokao=招考
zzhongkao=中考
zzhaokan=照看
zzhankai=绽开
zzhongkui=钟馗
zzhuangkuo=壮阔
zzhuankuai=砖块
zzhaikuan=债款
zzhuke=主课
zzhankuang=战况
zzongkuo=总括
zzhukao=主考
zzikua=自夸
zzhumu=瞩目
zzanmen=咱们
zzhaoming=照明
zzhima=芝麻
zzhoumi=周密
zzhuomo=琢磨
zzhemo=折磨
zzimu=字母
zzhimin=殖民
zzanmei=赞美
zzuiming=罪名
zzhamen=闸门
zzimei=姊妹
zzumu=祖母
zzhuomian=桌面
zzimu=字幕
zzhaomu=招募
zzhengming=争鸣
zzhenmi=缜密
zzhuomo=捉摸
zzhenmu=枕木
zzhimi=致密
zzimo=字模
zzhoumei=皱眉
zzhouma=咒骂
zzema=责骂
zzhaomian=照面
zzhumou=主谋
zzhimou=智谋
zzunming=遵命
zzongmiao=宗庙
zzhameng=蚱蜢
zzhumie=诛灭
zzuopin=作品
zzhipin=制品
zzhaopian=照片
zzaipei=栽培
zzhaopin=招聘
zzhuangpei=装配
zzhipei=支配
zzhapian=诈骗
zzhenpo=侦破
zzhenpin=珍品
zzhanpin=展品
zzhipu=质朴
zzhangpeng=帐篷
zzaopo=糟粕
zzhaopai=照排
zzhipian=纸片
zzhengpin=正品
zzongpai=宗派
zzhupao=助跑
zzengpin=赠品
zzhipai=纸牌
zzaopen=澡盆
zzhengpin=征聘
zzhengque=正确
zzhengquan=证券
zzhunque=准确
zzhaiquan=债券
zzuanqian=赚钱
zzouqiao=走俏
zzhaiquan=债权
zzhengqi=整齐
zzhengqian=挣钱
zzhiqin=执勤
zzhaoqi=沼气
zzhengqi=蒸汽
zzhaiqu=摘取
zzuanqu=赚取
zzhongqing=钟情
zzhuoqing=酌情
zzhiqin=值勤
zzhengqiao=正巧
zzhenqin=珍禽
zzhiqi=稚气
zzuoqing=左倾
zzanqie=暂且
zzhiqu=志趣
zzhiqu=智取
zzhongqiu=仲秋
zzhiqian=纸钱
zzhaqu=榨取
zzhongqing=衷情
zzanque=暂缺
zzhiqu=知趣
zziqiang=自戕
zzhongqu=衷曲
zzuiqian=罪愆
zzhongshi=重视
zzhishi=知识
zzhanshi=战士
zzhuangshi=装饰
zzousi=走私
zzunshou=遵守
zzaoshou=遭受
zzanshi=暂时
zzhashi=扎实
zzanshang=赞赏
zzengsong=赠送
zzaosheng=噪声
zzuanshi=钻石
zzhongshen=终身
zzhushou=助手
zzhishu=植树
zzhengshi=正视
zzhusu=住宿
zzhushi=注视
zzhongsheng=终生
zzongshu=综述
zzhensuo=诊所
zzhishen=置身
zzhongshi=忠实
zzhaoshi=昭示
zzisheng=滋生
zzhuisu=追溯
zzhunshi=准时
zzhongsheng=钟声
zzhushi=注释
zzhenshi=珍视
zzhongshen=终审
zzhushu=著述
zzhaoshe=照射
zzaoshu=早熟
zzuse=阻塞
zzhuansu=转速
zzhengshu=整数
zzhushi=主食
zzise=紫色
zzhenshe=震慑
zzishi=姿势
zzaisha=宰杀
zzaoshu=枣树
zzhishang=智商
zzhaoshi=肇事
zzashe=咋舌
zzhongshu=中枢
zzongshu=总署
zzisi=自私
zzhushou=祝寿
zzhuangshi=壮士
zzangshen=葬身
zzishu=自述
zzhusun=竹笋
zzongshi=宗师
zzansong=赞颂
zzangsong=葬送
zzhuangshu=装束
zzhuanshun=转瞬
zzhuangshi=壮实
zzengshan=增删
zzuosui=作祟
zzhuishu=赘述
zzhongshu=中暑
zzishi=滋事
zzhisang=治丧
zzusun=祖孙
zzuoshi=坐视
zzhushuai=主帅
zzaoshi=早逝
zzhushi=柱石
zzhishi=直视
zzishi=自恃
zzasui=砸碎
zzushang=祖上
zzhunsheng=准绳
zzhishuang=直爽
zzashua=杂耍
zzushi=祖师
zzasui=杂碎
zzisheng=吱声
zzhuanshu=专署
zzaoshuai=早衰
zzhongshang=重赏
zzhuishu=追述
zzhushu=注疏
zzise=姿色
zzhuoshang=灼伤
zzuoshou=做寿
zzhashou=扎手
zzisi=子嗣
zzousan=走散
zzhaoshuo=照说
zzhenshi=诊视
zzhaoshan=罩衫
zzhuangsuan=装蒜
zzhengti=整体
zzhuangtai=状态
zzengtian=增添
zzhengtao=整套
zzitai=姿态
zzantong=赞同
zzhengtian=整天
zzantan=赞叹
zzanting=暂停
zzhongtu=中途
zzheteng=折腾
zzhangtie=张贴
zzhongtuo=重托
zzutan=足坛
zzhengtu=征途
zzhengtuo=挣脱
zzhiti=肢体
zzuantan=钻探
zzhetang=蔗糖
zzhentan=侦探
zzhutuo=嘱托
zzhongtou=钟头
zzhuantou=砖头
zzhitiao=纸条
zzhitou=枝头
zzhentou=枕头
zzhaotie=招贴
zzhaotou=兆头
zzhantie=粘贴
zzhitiao=枝条
zzhutong=竹筒
zzaotang=澡堂
zzaota=糟蹋
zzitie=字帖
zzhentao=枕套
zzuotai=作态
zzhuntou=准头
zzhangwo=掌握
zzhiwu=植物
zzhouwei=周围
zzhaiwu=债务
zzhongwu=中午
zziwei=滋味
zzhiwu=织物
zzhanwen=站稳
zzhuanwen=撰文
zzhuanwa=砖瓦
zzangwu=赃物
zzhenwei=真伪
zzhuanwan=转弯
zzhouwen=皱纹
zzhiwen=质问
zzhiwen=指纹
zcangwen=藏文
zzhuwei=助威
zzewen=责问
zzhengwu=正午
zzhenwang=阵亡
zzhuwang=蛛网
zziwei=自慰
zzhanwang=瞻望
zzengwu=憎恶
zzhengwu=正误
zzhiwu=支吾
zziwen=自刎
zzhixing=执行
zzhuxi=主席
zzhixu=秩序
zzhexue=哲学
zzhenxing=振兴
zzanxing=暂行
zzunxun=遵循
zzaoxing=造型
zzaixi=仔细
zzhuanxie=撰写
zzhongxing=中型
zzhenxi=珍惜
zzhongxin=衷心
zzhongxing=重型
zzhixiao=滞销
zzhuanxing=转型
zzhenxi=珍稀
zzhuangxie=装卸
zzuxian=祖先
zzhixiang=纸箱
zzuixing=罪行
zzixing=字形
zzhengxiu=整修
zzouxiao=奏效
zzhaoxiang=照相
zzhixun=质询
zzhunxu=准许
zzhixiao=知晓
zzhengxing=整形
zzanxu=赞许
zzhixi=窒息
zzhouxuan=周旋
zzhixie=致谢
zzhengxiong=争雄
zzhuxing=助兴
zzhuangxiang=装箱
zzixu=自诩
zzhixu=只许
zzhaoxia=朝霞
zzuixin=醉心
zzhixi=知悉
zzhongxiao=忠孝
zzhaixiao=窄小
zzaixiang=宰相
zzhaoxi=朝夕
zzhixie=纸屑
zzhaoxue=昭雪
zzuoxi=作息
zzhixia=直辖
zzhongxin=忠心
zzhouxiang=周详
zzixu=自序
zzhunxing=准星
zzhajiang=诈降
zzhongyu=终于
zzhuanyi=转移
zzhongyi=中医
zzhiyuan=支援
zzhengyi=争议
zzanyang=赞扬
zzhanyi=战役
zzhouye=昼夜
zzunyan=尊严
zzuanyan=钻研
zzhuoyue=卓越
zzhuyuan=祝愿
zzhuangyan=庄严
zzhiyu=之余
zzanyu=赞誉
zzeyou=择优
zzaoyu=遭遇
zzhaoyang=照样
zzaoyin=噪音
zzhaiyao=摘要
zzuyong=租用
zzhongyou=中游
zzhuangyuan=状元
zzhongyu=忠于
zzhayao=炸药
zzhuangyuan=庄园
zzaoyi=造诣
zziyou=自幼
zzhuyan=主演
zzhunyu=准予
zzhiyi=置疑
zzhiyi=执意
zzhiyi=质疑
zzhiyin=知音
zzongying=踪影
zzhanyang=瞻仰
zzhuoyi=桌椅
zzhaoyao=照耀
zzuoyi=左翼
zzhongyi=忠义
zzhiye=枝叶
zzheyang=遮阳
zziyang=滋养
zzhayou=榨油
zzhuanyou=转悠
zzhayan=眨眼
zzhouyou=周游
zzengyu=赠与
zzhiyou=挚友
zzhenyan=箴言
zzaoyao=造谣
zzaoyang=遭殃
zzheyan=遮掩
zzengyuan=增援
zzaiyu=载誉
zzhaoying=照应
zzhiyu=智育
zziyi=恣意
zzouyue=奏乐
zzhuanyi=转椅
zzuanying=钻营
zzheyao=折腰
zzengyan=赠言
zzhenyuan=震源
zzhengyou=诤友
zzhangyi=仗义
zzhiye=汁液
zzhaiyuan=宅院
zzhaoyao=招摇
zzhuangyu=状语
zzuyue=租约
zzhuiyan=赘言
zzuye=祖业
zziyin=字音
zzengyue=赠阅
zzayin=杂音
zzhiyi=直译
zzhaoya=爪牙
zzhiyan=纸烟
zzuiyi=醉意
zzhongyan=忠言
zzhaiyi=摘译
zzhengyin=正音
zzhuye=主页
zzuzhi=组织
zzuizhong=最终
zzhongzhi=种植
zzhuzhai=住宅
zzhuangzhi=装置
zzunzhong=尊重
zzhizhu=支柱
zzhize=职责
zzongzhi=宗旨
zzhengzhou=郑州
zzhunze=准则
zzizhu=资助
zzhizhao=执照
zzhengzhi=整治
zzanzhu=赞助
zzhengzheng=整整
zzhenzhi=针织
zzangzu=藏族
zzhongzhi=终止
zzhize=指责
zzhizheng=执政
zzhuzao=铸造
zzhengzhuang=症状
zzhongzu=种族
zzhuizong=追踪
zzuzhi=阻止
zzhizhu=执著
zzizhi=资质
zzhaizi=摘自
zzhengzhong=郑重
zzhizhang=纸张
zzunzhao=遵照
zzhuozhu=卓著
zzhuizhu=追逐
zzhengzha=挣扎
zzhuozi=桌子
zzhuzhang=助长
zzhengzong=正宗
zzizun=自尊
zzhuangzhong=庄重
zzhenzhi=诊治
znianzhuan=辗转
zzhengzhi=争执
zzhenzhi=真挚
zzhouchang=州长
zzazhi=杂质
zzhuzai=主宰
zzanzhu=暂住
zzaizhong=栽种
zzaizhi=栽植
zzizhu=自助
zzichang=滋长
zzhaozhang=照章
zzongzu=宗族
zzhuangzi=庄子
zzhuzha=驻扎
zzuzong=祖宗
zzuozheng=佐证
zzhenzuo=振作
zzhaoze=沼泽
zzhuangzhen=装帧
zzhuangzu=壮族
zzhuzi=竹子
zzhuzhi=住址
zzhuzi=柱子
zzhizhu=植株
zzhenzai=赈灾
zzhizhu=蜘蛛
zzhizhang=执掌
zzongzi=粽子
zzhaizi=寨子
zzhenzhong=震中
zzhenzhuo=斟酌
zzeze=啧啧
zzhongzhen=忠贞
zzhaizhu=债主
zzhizhang=滞胀
zzhengzhao=征兆
zzhengzhuang=整装
zzaozai=遭灾
zzhuozhuang=茁壮
zzhizi=质子
zzuizheng=罪证
zzhunzhun=谆谆
zzhongzhang=肿胀
zzhizun=至尊
zzuize=罪责
zzengzu=曾祖
zzuzhou=诅咒
zzhezhou=褶皱
zzhuozhu=捉住
zzhengzhang=证章
zzhuozhuo=灼灼
zzuizhuang=罪状
zzhaozu=招租
zzhuzhen=助阵
zzhongze=重责
zzuchang=族长
zzhuanzeng=转赠
zzuozhong=座钟
zzhizui=治罪
zzhuzhan=助战
zzhizhu=踯躅
zzhouzhe=皱褶
zzhuanze=专责
zzhazi=渣滓
zzhuozuo=拙作
zzhengzhao=征召
zzhaozhu=昭著
zzizhong=辎重
zzhuizang=追赃
zzhizhai=指摘
zzhuazi=爪子
zzhuanzi=篆字
zzhouzao=周遭
zzhaozhi=照直
zzunchang=尊长
zzhuozhu=拙著
zzhouzhang=周章
zzaizang=栽赃
zzhizi=稚子
zzaozi=凿子
zzhaizi=宅子
zquangu=颧骨
ztaotie=饕餮
znangpei=囊胚
znangzhong=囊肿
zluxian=露馅
zloulian=露脸
zlouxiang=露相
zloubai=露白
zloutou=露头
zganjiang=赣江
zbinfa=鬓发
zruchong=蠕虫
zjueshuo=矍铄
zguanjiang=灌浆
zguanshui=灌水
zguanqu=灌区
zmanyu=鳗鱼
zzaolei=藻类
zbuji=簿记
zbuzi=簿子
zbanmo=瓣膜
zlusi=鹭鸶
zbianda=鞭打
zlata=邋遢
zbengji=蹦极
zfuzhe=覆辙
zfumei=覆没
zfanfu=翻覆
zfanling=翻领
zfandao=翻倒
zfanye=翻页
zpixing=癖性
zhansheng=鼾声
zdailv=黛绿
znianmo=黏膜
znianjiao=黏胶
zeyu=鳄鱼
zzhouyu=骤雨
zshuangqi=霜期
zshuangtian=霜天
zxiangfan=襄樊
zxiangyang=襄阳
zzhanglang=蟑螂
zluoshuan=螺栓
zluogan=螺杆
zxiantai=藓苔
zcangyu=藏语
zzangxiang=藏青
zcangyi=藏医
zcangmin=藏民
zcangli=藏历
zbibo=臂膊
ztunbu=臀部
zjilv=羁旅
zfansuo=繁琐
zfannan=繁难
zfanyu=繁育
zfanhua=繁花
zjiaoshi=礁石
zlinsuan=磷酸
zlinfei=磷肥
zlinguang=磷光
zlinhuo=磷火
zcaliang=擦亮
zcawang=擦网
zcashang=擦伤
zdaixiao=戴孝
zhuimo=徽墨
zhaojiao=嚎叫
zzhegu=鹧鸪
zhuode=霍地
zdiaoqi=雕漆
zjingxiang=镜像
zjingmian=镜面
zxinglai=醒来
zxiehou=邂逅
zbiannan=辩难
zbianming=辩明
zbianxi=辨析
zzengkuan=赠款
zzenggei=赠给
zzengyu=赠予
zhengqi=衡器
zhengyang=衡阳
zhengshui=衡水
zhengshan=衡山
zbomu=薄暮
zbaowu=薄雾
zbaojiu=薄酒
zbaocui=薄脆
zbaobing=薄饼
zbaoban=薄板
zbaozhi=薄纸
zbaopian=薄片
zjiaoxiao=缴销
zjiaofei=缴费
ztangjiang=糖浆
ztanglei=糖类
ztangyi=糖衣
ztangshui=糖水
ztanghua=糖化
zmohao=磨耗
zzhangqi=瘴气
zranqi=燃起
zranyou=燃油
zranqi=燃气
zbinwei=濒危
zjiju=激剧
zjijiang=激将
zchugui=橱柜
zchengse=橙色
zzhengliu=整流
zzhengdian=整点
zzhengbei=整备
zzhengkuai=整块
zzhengdi=整地
zzhengyue=整月
zzhengri=整日
zleigu=擂鼓
zlandai=懒怠
zshanbian=嬗变
zbichu=壁橱
zbihu=壁虎
zbilu=壁炉
zbibao=壁报
zbili=壁立
zpipa=噼啪
zlizu=黎族
zhuixia=麾下
zjiyu=鲫鱼
zpiaomiao=飘渺
zpiaobo=飘泊
zzhuanxu=颛顼
zanma=鞍马
zanshan=鞍山
zxiebang=鞋帮
zmeijun=霉菌
zmeisu=霉素
zcusuan=醋酸
zzuijiu=醉酒
zzunyi=遵义
zlinxuan=遴选
ztaping=踏平
ztashang=踏上
zouhe=耦合
zciba=糍粑
zlouzi=篓子
zzhuanshu=篆书
zgaochou=稿酬
zdaozhong=稻种
zdaomi=稻米
zpanshi=磐石
zleiluo=磊落
zmingmu=瞑目
zbiesan=瘪三
zyiyi=熠熠
zshulu=熟路
zshuren=熟稔
zshudu=熟读
zshushou=熟手
zchaojie=潮解
zhengbin=横滨
zhengman=横蛮
zhengduan=横断
zhengpi=横披
zhengqie=横切
zzhangshu=樟树
zzhangmu=樟木
zcaogang=槽钢
zbaobing=暴病
zbaozheng=暴政
zbaodong=暴动
zbaoguang=暴光
zmuqi=暮气
zsazhong=撒种
zchengchuan=撑船
zdezhou=德州
zyingdie=影碟
zlvdai=履带
zmohei=墨黑
zzengzhi=增殖
zzengyi=增益
zzengbo=增拨
zxixi=嘻嘻
zsijiao=嘶叫
zpichai=劈柴
zpitou=劈头
zpikai=劈开
zbisai=鼻塞
zbiqiang=鼻腔
zbiyan=鼻烟
zbiyan=鼻炎
zbijian=鼻尖
zxianyu=鲜鱼
zshaoguan=韶关
zjingji=静寂
zjinghou=静候
zjingting=静听
zmeisha=镁砂
zduxin=镀锌
zduyin=镀银
zduanjian=锻件
zsuanteng=酸疼
zsuandu=酸度
zsuanwei=酸味
zsuanhua=酸化
zjiaosu=酵素
zhehe=赫赫
zsaihou=赛后
zhaodu=豪赌
zhaoyu=豪语
zhaozhai=豪宅
zlanyan=谰言
zdalian=褡裢
zhese=褐色
zguoxie=裹胁
zweiran=蔚然
zbangbi=膀臂
zfuzhu=腐竹
zzhaoduan=肇端
zzhaoshi=肇始
zjuhe=聚合
zcuiniao=翠鸟
zsaosi=缫丝
zsuoju=缩聚
zsuolve=缩略
zsuofang=缩放
zjinglian=精炼
zjingkuang=精矿
zjinggong=精工
zguanxian=管弦
zduande=端的
zduanchu=端出
zwenya=稳压
zciju=磁矩
zchar=碴儿
ztansuan=碳酸
ztanhua=碳化
zjianhua=碱化
zbikong=碧空
zbibo=碧波
zbiyu=碧玉
zchouzhe=瞅着
zchoujian=瞅见
zwenbing=瘟病
zsaoyang=瘙痒
zlali=瘌痢
zyiju=疑惧
zyisi=疑似
zyiyi=疑义
zrongrong=熔融
zronglian=熔炼
zrongdian=熔点
zronghe=熔合
zxiongdan=熊胆
zshanqing=煽情
zshanqi=煽起
zweifang=潍坊
zzhangzhou=漳州
zluohe=漯河
zmanhua=漫话
zmanyan=漫延
zcaoyun=漕运
zloubao=漏报
zloushui=漏水
zqiqi=漆器
zdiluo=滴落
zdishui=滴水
zqianshou=歉收
zqiannian=歉年
zmoshu=模数
zmuyu=模具
zmuzi=模子
zliudan=榴弹
zbangyan=榜眼
zqijian=旗舰
zqiaomen=敲门
zshuaidiao=摔掉
zshuaihuai=摔坏
zjiemian=截面
zjiezhi=截肢
zjiezhu=截住
zfuyu=孵育
znenya=嫩芽
znenye=嫩叶
zyanhong=嫣红
zdipai=嫡派
zdiqin=嫡亲
zpiaochang=嫖娼
zpiaoji=嫖妓
zshangqing=墒情
zjingwai=境外
zjiajing=嘉靖
zjiaqing=嘉庆
zjiaxing=嘉兴
zjiahe=嘉禾
zsengren=僧人
zgumo=鼓膜
zguqi=鼓起
zgusheng=鼓声
zgufeng=鼓风
ztouzi=骰子
zpindai=频带
zbaozai=雹灾
zleibao=雷暴
zleidong=雷动
zlingdan=零蛋
zlingdan=零担
zlinghua=零花
zlingluan=零乱
zchuju=雏菊
zchuniao=雏鸟
zyongzheng=雍正
zqueru=阙如
zjianwei=键位
zjinji=锦鸡
zjinlun=锦纶
zjinzhou=锦州
zzhuixing=锥形
zxibo=锡箔
zxijin=锡金
zcuozong=错综
zbilou=鄙陋
zbiren=鄙人
zyaoce=遥测
zpigu=辟谷
zshujia=输家
zshuguang=输光
zshudian=输电
zluba=路霸
zlupang=路旁
zlaizhang=赖账
zyuwei=誉为
zchujiao=触角
zchuwang=触网
zchumu=触目
zjienang=解囊
zjieyi=解颐
zjiema=解码
zwolun=蜗轮
zfengniao=蜂鸟
zxuji=蓄积
zjili=蒺藜
ztengteng=腾腾
ztengda=腾达
zfuqiang=腹腔
zfutong=腹痛
zfuzhang=腹胀
zyaozhui=腰椎
zxingwei=腥味
zqunju=群聚
zzhixin=置信
zzhiyu=置于
zzuikui=罪魁
zchanzai=缠在
zjianpin=简拼
zjianma=简码
zjianyue=简约
zchousuan=筹算
zchoumou=筹谋
zkejiu=窠臼
zfuxing=福星
zfudi=福地
zpengdao=碰到
zbeilin=碑林
zbeitie=碑帖
zaikou=碍口
zlulu=碌碌
zpengsuan=硼酸
zpengsha=硼砂
zaipang=矮胖
zduxue=督学
zdujun=督军
zshuishu=睡熟
zshuiyi=睡椅
zyuxie=瘀血
zchizui=痴醉
zchichi=痴痴
zruixing=瑞星
zxiance=献策
zxianji=献技
zxianchu=献出
zxianshang=献上
zzhaobi=照壁
zzhaozhe=照着
zzhaodu=照度
zzhaoshi=照实
zmeizhi=煤质
zshazhu=煞住
zshache=煞车
zjianyao=煎药
zhuanghuang=煌煌
zduanshao=煅烧
zlijiang=漓江
zlandiao=滥调
zlanfa=滥伐
zlanfa=滥发
zgunzhu=滚珠
zgunlun=滚轮
zdianchi=滇池
zronghe=溶合
zhuiyu=毁誉
zdianxia=殿下
zgaisuan=概算
zlouge=楼阁
zchunshu=椿树
zanxiang=暗箱
zanjian=暗箭
zanchao=暗潮
zanbao=暗堡
zanlian=暗恋
zanma=暗码
znuanyi=暖意
znuanfang=暖房
zxinlang=新浪
zxinmiao=新苗
zshukong=数控
ztanshang=摊商
zyaohan=摇撼
zyaochuan=摇船
zyaoche=摇车
zyaoshou=摇手
zxiejuan=携眷
zbandiao=搬掉
zbanzou=搬走
zbannong=搬弄
zbankai=搬开
zyuren=愚人
zweili=微粒
zpinfei=嫔妃
zxianzeng=嫌憎
zxiane=嫌恶
ztianman=填满
ztianbiao=填表
ztianping=填平
zchixiao=嗤笑
zqinku=勤苦
zqinxue=勤学
zshashi=傻事
zcuiming=催命
zcuihai=催还
zcuihua=催化
zdingli=鼎力
zheixiang=黑箱
zheixiong=黑熊
zheidiao=黑貂
zluxun=鲁迅
zpianqian=骗钱
zgunong=雇农
zguche=雇车
zjiju=集聚
zxiongji=雄鸡
zailu=隘路
zaikou=隘口
zkuolao=阔佬
zlanwei=阑尾
zruijiao=锐角
zguozi=锅子
zsuomen=锁门
zsuoshang=锁上
zliansuo=链锁
zlianjie=链接
zpuzhan=铺展
zpugui=铺轨
zpukai=铺开
zzhutie=铸铁
zzhugang=铸钢
zzhuxing=铸型
zzhucheng=铸成
zzhujian=铸件
zzhugong=铸工
zshiwen=释文
zyijing=遗精
zyizhu=遗著
zyiniao=遗尿
zyimin=遗民
zdaocha=道岔
zxialing=遐龄
zeyi=遏抑
zbianshu=遍数
zbihun=逼婚
zbishi=逼视
zbisi=逼死
zbiren=逼人
zbeizi=辈子
zchaoba=超拔
zshangyue=赏月
zshuhui=赎回
zfushi=赋诗
zfuyou=赋有
zxieding=谢顶
zxiechen=谢忱
zkudang=裤裆
zzhuangtian=装填
zcaizhi=裁制
zcaichu=裁处
zgeli=蛤蜊
zcongbai=葱白
zluopin=落聘
zpizang=脾脏
zlianxi=联席
zlianzhong=联众
zbianzuan=编纂
zbiancheng=编程
zbianyu=编余
zhuanliu=缓流
zhuanji=缓急
zhuancun=缓存
zhuanban=缓办
zzijing=紫荆
zziguang=紫光
zsumi=粟米
zdali=答礼
zzhulu=筑路
zdengyao=等腰
zdengju=等距
zcuanfan=窜犯
zchuangkuang=窗框
zchuangwai=窗外
zshaodeng=稍等
zshaohou=稍候
zshaoyou=稍有
zshaowei=稍为
zchengshi=程式
zxini=稀泥
zxitu=稀土
zqueran=确然
zqueyou=确有
zliuhuang=硫磺
zliusuan=硫酸
zliuhua=硫化
zxiaosuan=硝酸
zduanqun=短裙
zduanqian=短浅
ztongyang=痛痒
zshuli=疏离
zfanshu=番薯
zpanyu=番禺
zqiongyao=琼瑶
zqiongzhi=琼脂
zqionghai=琼海
zqinjian=琴键
zqinxian=琴弦
zxiniao=犀鸟
zzhufei=煮沸
zjiaoyou=焦油
zjiaozuo=焦作
zchuxian=滁县
zshizhen=湿疹
zshiqi=湿气
zzhanjiang=湛江
zxiangtan=湘潭
zhubin=湖滨
zhuzhao=湖沼
zhuzhou=湖州
zhuqu=湖区
zyouyi=游移
zyousi=游丝
zyouli=游历
zyouyi=游弋
zwenre=温热
zwenzhou=温州
zzhada=渣打
zducao=渡槽
zduhai=渡海
zduhe=渡河
zdanfei=氮肥
zyelin=椰林
zzhibao=植保
zyidian=椅垫
zbangda=棒打
zbangzi=棒子
zqitan=棋坛
zmianqian=棉签
zchaojin=朝觐
zzhaohui=朝晖
zzuichi=最迟
zzanyong=暂用
zzanwu=暂无
zjingli=晶粒
zjingliang=晶亮
zqinglun=晴纶
zbanban=斑斑
zbanhen=斑痕
zbanyan=斑岩
zbanjiu=斑鸠
zbanwen=斑纹
zbanzhu=斑竹
zbanbai=斑白
zjingqing=敬请
zjinglao=敬老
zdunhuang=敦煌
zsanshe=散射
zsanbing=散兵
zdaqiang=搭腔
zdali=搭理
zdazai=搭载
zdaqiao=搭桥
zsouhu=搜狐
zsaoyang=搔痒
zchanza=搀杂
zjiemi=揭秘
zjiepi=揭批
zwojin=握紧
zwoyou=握有
zchacao=插槽
zchahua=插画
zchajian=插件
zchashang=插上
ztidu=提督
ztisu=提速
zfenji=愤激
zrehuo=惹火
zhuicun=惠存
zhuozhong=惑众
zbeiqi=悲戚
zbeimin=悲悯
zxunxu=循序
zyudi=御敌
zqiangbian=强辩
zqiangyan=强颜
zqiangsuan=强酸
zqiangdu=强渡
zcuoe=嵯峨
zqianru=嵌入
zzunshi=尊师
zyuju=寓居
zhanlu=寒露
zhanjin=寒噤
zhanmao=寒毛
zhanshi=寒士
zfukuang=富矿
zfuyu=富余
zfuli=富丽
zzisheng=孳生
zmeishuo=媒妁
zlou0luo=喽啰
zpenzui=喷嘴
zpenwu=喷雾
zpenhu=喷壶
zpenshui=喷水
zhezui=喝醉
zhecha=喝茶
zxihuo=喜获
zxiyu=喜雨
zxitie=喜帖
zhouyan=喉炎
zshanbian=善变
zkashi=喀什
zjiujiu=啾啾
zboya=博雅
zbolan=博览
zboyi=博弈
zbocai=博采
zbowu=博物
zboshi=博识
zbogu=博古
zgexian=割线
zshengfan=剩饭
zaoran=傲然
zdaizu=傣族
zhuangshan=黄鳝
zhuangfeng=黄蜂
zhuangli=黄鹂
zhuangma=黄麻
zhuangtong=黄铜
zhuangmei=黄梅
zhuangda=黄疸
zhuangpu=黄埔
zmahuang=麻黄
zmafang=麻纺
zhongyun=鸿运
zqiqiang=骑墙
zqiche=骑车
zqishi=骑士
zxianbing=馅饼
zjingxiang=颈项
zpojia=颇佳
zlinglu=领路
zlingdao=领到
zlingjin=领巾
zxueyuan=雪冤
zlongxiong=隆胸
zyinjiang=银奖
zyinkuang=银矿
zyinbei=银杯
zyinse=银色
zyinguang=银光
zanyan=铵盐
zjiaolian=铰链
zxichuang=铣床
ztongqi=铜器
ztongluo=铜锣
ztonglv=铜绿
ztongkuang=铜矿
ztongban=铜板
ztongyuan=铜元
zyile=逸乐
zdaizhu=逮住
zjujin=距今
zyuesheng=跃升
zshezhang=赊账
zxiediao=谐调
zxiezhen=谐振
zxiehe=谐和
zhuangcheng=谎称
zmoumian=谋面
zjiasha=袈裟
zxianming=衔命
zdanpin=蛋品
zdanbai=蛋白
zguhuo=蛊惑
zshedan=蛇胆
zzhuya=蛀牙
zxuxiang=虚像
zyingsi=营私
zcuiqu=萃取
zfeibo=菲薄
zcailan=菜篮
zcaipu=菜圃
zcainiao=菜鸟
zjunlei=菌类
zjunzhong=菌种
zjunfei=菌肥
zjunsi=菌丝
zchuanbu=船埠
zchuanwei=船桅
zchuanwei=船尾
zchuanwu=船坞
zliandan=脸蛋
zlianpen=脸盆
zlianxing=脸型
zliankong=脸孔
ztuoli=脱粒
ztuodiao=脱掉
ztuotai=脱胎
ztuoke=脱壳
ztuowei=脱位
ztuoyi=脱衣
ztuochu=脱出
zjiaota=脚踏
zjiaoban=脚板
zjiaoya=脚丫
zbogeng=脖颈
zyinian=翌年
zqiangji=羟基
zlvyin=绿茵
zchouzi=绸子
zbenglian=绷脸
zmianmi=绵密
zweizu=维族
zchuoyue=绰约
zxuqian=续签
zlizhuang=粒状
zlizi=粒子
zfuzhou=符咒
zzhangyu=章鱼
zyizai=移栽
zyiwei=移位
zhuoshou=祸首
zjipin=祭品
zpiaohui=票汇
zguigang=硅钢
zguipian=硅片
zyanzhao=眼罩
zyandai=眼袋
zchengfan=盛饭
zpanfu=盘符
zdaohan=盗汗
zgaiyin=盖印
zzhichuang=痔疮
zlveyou=略有
zlvejia=略加
ztiansuan=甜酸
ztianxiang=甜香
zliyu=理喻
zqiujun=球菌
zqiujing=球茎
zmaoyan=猫眼
zzhuluo=猪猡
zzhujuan=猪圈
zzhuyou=猪油
zzhupi=猪皮
zcaiquan=猜拳
zcaichu=猜出
zmengdie=猛跌
zliehuo=猎获
zlieqi=猎奇
zhanqiang=焊枪
zhantiao=焊条
zwanji=烷基
zyuge=渔歌
zyulun=渔轮
zyuju=渔具
zqingqu=清癯
zqingxi=清溪
zqinghui=清辉
zqinggui=清规
zyansi=淹死
zhuntong=混同
zhunchong=混充
zshenlan=深蓝
zshentou=深透
zshengeng=深耕
zhuainan=淮南
zhuaihe=淮河
zcuihuo=淬火
zyinwei=淫猥
zyinyu=淫雨
zlinbing=淋病
zzibo=淄博
zhanyi=涵义
zyeya=液压
zfuling=涪陵
zjianbo=检波
ztidu=梯度
ztici=梯次
zmeilin=梅林
zmeizi=梅子
zliangshan=梁山
zcaocao=曹操
zzulei=族类
zxuanwo=旋涡
zxielv=斜率
zxiejiao=斜角
zjiaoyan=教研
zjiuxian=救险
zchanjia=掺假
zqianke=掮客
zyanmei=掩没
ztuiwei=推诿
ztuiding=推定
ztuixiang=推向
ztuiche=推车
ztuikai=推开
ztuijie=推介
zkongjian=控件
zjiefeng=接缝
ztanxi=探悉
ztankuang=探矿
ztanzhen=探针
ztanchang=探长
zjuejin=掘进
zpaiguan=排灌
zpaixiao=排箫
zpaixu=排序
zpainiao=排尿
zqiasi=掐死
ztaochu=掏出
zshoujing=授精
zshouqi=授旗
zxiandong=掀动
zjieke=捷克
zcanjing=惨境
zcandu=惨毒
zcansha=惨杀
zweikong=惟恐
zweidu=惟独
zweiyou=惟有
zjingzhe=惊蛰
zjingju=惊惧
zjingyan=惊艳
zqingjing=情境
zqingsu=情愫
zqingyi=情谊
zxuandiao=悬吊
zhuanyou=患有
zyouyou=悠游
zdeyi=得宜
zcaitao=彩陶
zcaixian=彩显
zcailian=彩练
zcaihua=彩画
zcaitou=彩头
zdandao=弹道
ztanzhi=弹指
zdantou=弹头
zdanchu=弹出
zdanpian=弹片
zdangong=弹弓
zdanzi=弹子
zdanwan=弹丸
zlangfang=廊坊
zyongren=庸人
zshuwu=庶务
zchangshu=常熟
zweiman=帷幔
zweiwo=帷幄
zbengta=崩塌
zbenglie=崩裂
zyabi=崖壁
zchongzhen=崇祯
zchongyang=崇洋
ztucheng=屠城
zmizhi=密植
zmiji=密级
zmiyun=密云
zjiqing=寄情
zjiyu=寄语
zjilai=寄来
zjichu=寄出
zjizhu=寄主
zbiaozi=婊子
zgouwei=够味
zgouqiang=够呛
zduzui=堵嘴
zduihan=堆焊
zduifei=堆肥
ztanghuang=堂皇
zjilong=基隆
zjifu=基辅
zpeitu=培土
zxiaosheng=啸声
zluosuo=啰嗦
zshangbu=商埠
zshangqiu=商丘
zchangdie=唱碟
zweiwu=唯物
zweixin=唯心
zkancha=勘查
zleijin=勒紧
zleisi=勒死
zjianqie=剪切
zchangfu=偿付
ztoulou=偷漏
ztouyue=偷越
ztouyun=偷运
zxiexing=偕行
zjiamei=假寐
zjiahuo=假货
zjiaban=假扮
zgaoduan=高端
zgaoxiong=高雄
zgaolu=高炉
zgaomiao=高妙
zesi=饿死
zyushou=预售
zyure=预热
zyuzhan=预展
zyulan=预览
zyuzhi=预制
zyuhou=预后
zyufen=预分
zduncuo=顿挫
ztaotu=陶土
zlingsheng=铃声
ztiexiang=铁箱
ztiexie=铁屑
ztiezhi=铁质
ztieban=铁板
zjiafei=钾肥
zzuankong=钻孔
zzuanjing=钻井
zjiuquan=酒泉
zpeida=配搭
zpeigu=配股
zzhuoding=酌定
zdoudu=都督
zchenzhou=郴州
ztancheng=郯城
zbuzu=部族
zbubiao=部标
zzaozhi=造纸
zsujue=速决
ztongqin=通勤
zdougen=逗哏
ztujing=途经
zdibu=递补
zzhulu=逐鹿
zzhutiao=逐条
zzhuci=逐次
zzhuzi=逐字
zzhuyue=逐月
zzaibo=载波
zqibao=起爆
zqihang=起航
zganmang=赶忙
ztanfeng=谈锋
zdiaowen=调温
zkemu=课目
zkeye=课业
zqingwu=请勿
zbeibu=被捕
zbeifu=被俘
zcane=蚕蛾
zcanyong=蚕蛹
zcansang=蚕桑
zcanjian=蚕茧
zcansi=蚕丝
zbengbu=蚌埠
zbangke=蚌壳
zmoni=莫逆
zmoce=莫测
zputian=莆田
zyanyu=艳遇
zyanli=艳丽
zyanshi=艳史
zcangwei=舱位
zcangkou=舱口
zjianchang=舰长
zhanglu=航路
zhangchuan=航船
zhangci=航次
zzhiqian=致歉
zzhiai=致哀
zchouwei=臭味
zchouming=臭名
znaosui=脑髓
znaoliang=脑量
znaojiang=脑浆
znaoyan=脑炎
znaoji=脑际
znaozhi=脑汁
zcuixing=脆性
zxiongyi=胸臆
zxiongxian=胸腺
zxiongzhao=胸罩
zxiongzhui=胸椎
zjiaozhi=胶质
zyiye=胰液
zgenggeng=耿耿
zhaoneng=耗能
zhaocai=耗材
zgengzuo=耕作
zgengtian=耕田
zgengniu=耕牛
zbashi=罢市
zbale=罢了
zsuoni=索尼
zsushu=素数
zsuchang=素常
zsujie=素洁
zsuyou=素有
zfenji=粉剂
zfenzhuang=粉状
zfenchen=粉尘
zbimo=笔墨
zbiduan=笔端
zbitong=笔筒
zbigeng=笔耕
zbigan=笔杆
zxiaomao=笑貌
zxiaona=笑纳
zbali=笆篱
zchengchen=称臣
zjixue=积雪
zjifei=积肥
zjinian=积年
zjishui=积水
zjiqian=积欠
zyangtian=秧田
zzushui=租税
zlisao=离骚
zlixian=离弦
zlishi=砾石
zzashang=砸伤
zzale=砸了
zxuanyun=眩晕
zzhenpin=真品
zjianpiao=监票
zjiancha=监查
zyansuan=盐酸
zyanjian=盐碱
zyanlei=盐类
zyancheng=盐城
zyanlu=盐卤
zyanchang=盐场
zyantian=盐田
zyanye=盐业
zyanba=盐巴
zyizhi=益智
zbingta=病榻
zbinghuan=病患
zbingshi=病逝
zbingzhuang=病状
zbingkuang=病况
zzhenzi=疹子
zliuxiu=留宿
zpinggai=瓶盖
zhuichun=珲春
zlangji=狼籍
zlangchuang=狼疮
zdieniang=爹娘
zreya=热轧
zshaojian=烧碱
zshaoping=烧瓶
zshaojie=烧结
zshaobei=烧杯
zshaomai=烧卖
zshaoshui=烧水
zfanluan=烦乱
zwoliu=涡流
zwolun=涡轮
ztaosheng=涛声
zcencen=涔涔
zyongjin=涌进
zyongxiang=涌向
zyongru=涌入
zshean=涉案
zxiaomi=消弭
zxiaoqi=消气
zjinshi=浸湿
zjinzhong=浸种
zjinru=浸入
zhaiwan=海碗
zhailu=海陆
zyuxie=浴血
zfuxiang=浮想
zfudian=浮点
zfuzi=浮子
zliubi=流弊
zliudan=流弹
zliuzhi=流质
zliusu=流苏
zliuhan=流汗
ztairan=泰然
ztaian=泰安
zanji=氨基
zanshui=氨水
zlishu=梨树
zwuzhou=梧州
zshaotou=梢头
zhuashu=桦树
zqiaokong=桥孔
zjugan=桔柑
zsangye=桑叶
zanshu=桉树
ztaoyuan=桃源
ztaofu=桃符
ztaoyuan=桃园
zguipi=桂皮
zhengjia=桁架
zzaidao=栽倒
zzaihua=栽花
zgege=格格
zgesha=格杀
zgenliu=根瘤
zgenjing=根茎
zgenmao=根毛
zhetang=核糖
zhesuan=核酸
zheren=核仁
zzhuzhou=株洲
zxuxu=栩栩
zlizi=栗子
zchaicao=柴草
zchaimi=柴米
zchaihe=柴禾
zchaihuo=柴火
zshuozhou=朔州
zwandao=晚稻
zxiaode=晓得
zjincheng=晋城
zlvchang=旅长
zpangtong=旁通
zpangmen=旁门
zzhaifan=斋饭
zaobao=敖包
zdiwei=敌伪
zxiaoyou=效尤
zhuanhuo=换货
zbushi=捕食
zbuyu=捕鱼
zzhuodao=捉刀
zaizou=挨揍
zaizhe=挨着
zshanqu=扇区
zwuchu=悟出
zxibing=息兵
zgongting=恭听
zenshi=恩师
ztugong=徒工
zruosuan=弱酸
zzuoyi=座椅
zfengluan=峰峦
zemei=峨嵋
zshepin=射频
zkuanchang=宽畅
zkuanyu=宽余
zrongcuo=容错
zrongqing=容情
zrongliu=容留
zrongguang=容光
zjiaci=家慈
zjiazhai=家宅
zjiamu=家母
zhaixi=害喜
zena=婀娜
ztaotong=套筒
ztaosuo=套索
ztaolao=套牢
zxiazhong=夏种
zxiazhi=夏至
zyuantong=圆筒
zyuanpan=圆盘
zyuanding=圆顶
zyuanjiao=圆角
ztangdai=唐代
zchungao=唇膏
zchunchi=唇齿
zbuyang=哺养
zshaoyin=哨音
zyuanye=原液
zyuangu=原故
zniji=匿迹
zbaopi=剥皮
zbaoqu=剥去
zbaokai=剥开
zpoujie=剖解
zlingxun=凌汛
zdiaoluo=凋落
zliangshan=凉山
zzhunr=准儿
zmingfu=冥府
zjianbu=健步
zqingxie=倾泄
zhoujiao=候教
zhouzhen=候诊
zhouji=候机
zdaoda=倒置
zdaotan=倒坍
zshude=倏地
zbeisu=倍速
zanmen=俺们
zfujiao=俯角
zfuyang=俯仰
zchengjing=乘警
zchengshu=乘数
zchengxu=乘虚
zchengji=乘积
zchengchu=乘除
zchengshi=乘势
zguitai=鬼胎
zgumo=骨膜
zgupen=骨盆
zpianwen=骈文
zjiaozong=骄纵
zjiaoren=骄人
zxiangnang=香囊
zxiangzhi=香纸
zxianggua=香瓜
zshoutui=首推
zshouli=首例
zshouye=首页
zshiliang=食粮
zshiju=食具
zshirou=食肉
zshiyong=食用
zshunsui=顺遂
zxiangquan=项圈
zxiangbei=项背
zyinsu=音素
zyinxiao=音效
zyinrong=音容
zyinzhun=音准
zyinbo=音波
zgelv=革履
zmianshu=面熟
zmianpen=面盆
zmianban=面板
zxianzao=险遭
zxianai=险隘
zyunxing=陨星
zdoujun=陡峻
zbixia=陛下
zgeyuan=阁员
zguixiu=闺秀
zniukou=钮扣
zqinding=钦定
zganglan=钢缆
zgangping=钢瓶
zdunjiao=钝角
zgaizhi=钙质
zzhongzheng=重整
zzhongshi=重试
zzhongma=重码
zzhongqi=重启
zxunwei=逊位
zxuanpei=选配
zxuankuang=选矿
znier=逆耳
znizi=逆子
ztaosan=逃散
ztuizang=退赃
zzhuishou=追授
zzhuipeng=追捧
zbengchu=迸出
zmimeng=迷蒙
zmicai=迷彩
zmitu=迷途
zmihang=迷航
zmijin=迷津
zqingpiao=轻飘
zqingxing=轻型
zqingxian=轻闲
zqingzhou=轻舟
zyiwen=轶闻
zyishi=轶事
zzhouxiang=轴箱
zzhouwa=轴瓦
zhenian=贺年
zguifei=贵妃
zguifang=贵方
zyouyin=诱因
zwuguo=误国
zyujing=语境
zlansheng=览胜
zyaowei=药味
zyaoji=药剂
zqianma=荨麻
zhuangtan=荒滩
zhuangluan=荒乱
zcaosuan=草酸
zchapan=茶盘
zchazhuan=茶砖
zchadian=茶点
zchashi=茶室
zchafang=茶房
zchafan=茶饭
zchayuan=茶园
zchase=茶色
zfuling=茯苓
zmaidong=脉动
zhujiao=胡椒
zhuma=胡麻
zhutao=胡桃
zbaobo=胞波
zbaomei=胞妹
zbaodi=胞弟
zbaoxiong=胞兄
zshengquan=胜券
zpeiru=胚乳
ztaiwei=胎位
zbeizhe=背着
zbeiji=背脊
zbeixin=背信
zbeishi=背时
zbeiyin=背阴
zbeixin=背心
zbeishu=背书
zdannang=胆囊
zdanzhi=胆汁
zweichang=胃肠
znaijian=耐碱
znailao=耐劳
zmeiji=美籍
ztongyu=统驭
zjuemie=绝灭
zluoyi=络绎
zjiemo=结膜
zjiecai=结彩
zjiechang=结肠
zbangtui=绑腿
zbangfei=绑匪
zbangdai=绑带
zduxue=笃学
zshuqin=竖琴
zshuqi=竖起
zshuzhi=竖直
ztufei=突飞
zchuankong=穿孔
zmiaozhong=秒钟
zqiubo=秋播
zqiuhao=秋毫
zqiugeng=秋耕
zshenzhi=神智
zshentan=神坛
zkandiao=砍掉
zkanchai=砍柴
zkandao=砍刀
zqiqiang=砌墙
zshali=砂砾
zshayan=砂岩
zshabu=砂布
zmeijie=眉睫
zshengfu=省府
zxiangzhuang=相撞
zxiangju=相聚
zxiangcheng=相乘
zxiangying=相映
zxiangxing=相形
zxiangban=相伴
zyingman=盈满
zpenqiang=盆腔
zfengdian=疯癫
zyibing=疫病
zjiezhuang=界桩
zjiexian=界线
zjiehe=界河
zhenzhua=狠抓
zliantie=炼铁
zliangang=炼钢
zlianyou=炼油
zdianzhong=点钟
zdianxue=点穴
zzhasi=炸死
zzhashang=炸伤
zpaoting=炮艇
zpaohong=炮轰
ztanjing=炭精
ztanbi=炭笔
ztanju=炭疽
ztanhua=炭化
znongzhuang=浓妆
zcewen=测温
zceju=测距
zcekong=测控
zcezi=测字
zcechu=测出
zqiashang=洽商
zhuozui=活罪
zhuosai=活塞
zhuozhuo=活捉
zhongliang=洪量
zdongxiao=洞箫
zxixue=洗雪
zxilian=洗脸
zxiyi=洗衣
zyangyu=洋芋
zquanyuan=泉源
zquanzhou=泉州
zquanxia=泉下
zduliu=毒瘤
zduye=毒液
zduji=毒剂
zduchong=毒虫
zduzhi=毒汁
zcanzha=残渣
zcannve=残虐
zcansha=残杀
zshuyin=树荫
zshuguan=树冠
zbiaoliang=标量
zbiaogao=标高
zbiaocheng=标称
zbiaode=标的
zbiaogan=标杆
zbiaochu=标出
zshibing=柿饼
zliuzhou=柳州
zliuye=柳叶
zchazhao=查照
zchakan=查勘
zchashao=查哨
zyoumu=柚木
zyouzi=柚子
zroumei=柔媚
zbolin=柏林
zkurong=枯荣
zzhaoran=昭然
zchunbo=春播
zchungeng=春耕
zyingxiang=映像
zshiyong=施用
zguzhi=故知
zgutai=故态
zzhengtan=政坛
zzhengqi=政企
ztingxiong=挺胸
ztinghao=挺好
znuojie=挪借
zhuiquan=挥拳
zdangzhu=挡住
zdangfeng=挡风
zjiadai=挟带
zwatu=挖土
ztiaodan=挑担
ztiaohua=挑花
zanjie=按揭
zanna=按捺
zanmai=按脉
zgualing=挂零
zguaqian=挂牵
zshiyi=拾遗
zshiqu=拾取
zbaitang=拜堂
zqiaru=恰如
zhuihong=恢宏
zhengjiu=恒久
zhuangruo=恍若
zjizhou=急骤
zjiju=急遽
zsimou=思谋
zdaikao=待考
ztingyuan=庭园
zyouhun=幽魂
zyouqing=幽情
zyoumei=幽美
zzhenpin=帧频
zdaizhuang=带状
zxiangkou=巷口
zchaiyi=差役
zgongwei=宫闱
zxianzheng=宪政
zxuanjiao=宣教
zxuanshi=宣示
zketang=客堂
zkehuo=客货
zjiaor=娇儿
zweihai=威海
zweiquan=威权
zzoujie=奏捷
zkuining=奎宁
zfuzhen=复诊
zchengbao=城堡
zchenghuang=城隍
zchengguo=城郭
zchengfu=城府
zkuadiao=垮掉
zkenqu=垦区
zhuahua=哗哗
zbiji=哔叽
zkuanglang=哐啷
zhami=哈密
zpinpai=品牌
zpincha=品茶
zpinming=品茗
zpinlei=品类
zpinming=品名
zpinmu=品目
zaiqi=哀戚
zaitong=哀恸
zailian=哀怜
zaisu=哀诉
zaiyue=哀乐
zgezi=咯吱
zkaxie=咯血
zliezui=咧嘴
zbianpin=变频
zbiannuan=变暖
zbiansu=变速
zbianyi=变异
zbianhuan=变幻
zshouyuan=受援
zshouhui=受惠
zshousun=受损
zhouyi=厚谊
zxiexia=卸下
znanduan=南端
znance=南侧
zboran=勃然
zboqi=勃起
zbobo=勃勃
zjianma=剑麻
zqianzhan=前瞻
zqianduan=前端
zqianxian=前嫌
zqianshao=前哨
zqianmao=前茅
zxueping=削平
zguanyi=冠以
zmaozhe=冒着
zmaodu=冒渎
zyangzhu=养猪
zyangcan=养蚕
zyangbing=养兵
zziyou=兹有
zbaomiao=保苗
zbaoyu=保育
zbianni=便溺
zbianxie=便携
zhoujue=侯爵
zhouma=侯马
zliangli=亮丽
zlinjie=临界
zlindao=临到
zlinzou=临走
zlinyi=临沂
zlinwei=临危
zchitiao=齿条
zmingjin=鸣金
zyugan=鱼竿
zyuluan=鱼卵
zyucha=鱼叉
ztuofeng=驼峰
ztuorong=驼绒
zzhuhu=驻沪
zdingban=顶板
zfeidian=非典
zqingzang=青藏
zshanbei=陕北
zlougui=陋规
zjinzhi=金质
zcaikuang=采矿
zzhengma=郑码
zyuyu=郁郁
zpoyu=迫于
zhonghong=轰轰
zruanguan=软管
zruanqu=软驱
zruanti=软体
zruanpian=软片
zzhuanlu=转炉
zbianzhi=贬职
zbianjia=贬价
zbianyi=贬义
ztanchi=贪吃
zzhiliao=质料
zhuopiao=货票
zhuolang=货郎
zhuodan=货单
zbaixu=败絮
zbaigei=败给
zxianda=贤达
zxiangshu=详述
zxiangshi=详实
zxiangjian=详见
zquanzhu=诠注
zhuabing=话柄
zchengpin=诚聘
zchengxin=诚信
zshijing=试镜
zshiyang=试样
zshizhong=试种
zshishi=试试
zshiji=试剂
zshizhi=试制
zshizhi=试纸
zshiban=试办
zshichuang=视窗
zshijie=视界
zshiting=视听
zshitong=视同
zguiyue=规约
zchenying=衬映
zchendian=衬垫
zbiaolian=表链
zbiaojie=表姐
zbiaomei=表妹
zbiaoshu=表叔
zbiaodi=表弟
zhuxiao=虎啸
zmaodun=茅盾
zmaoce=茅厕
zbenfen=苯酚
zbenan=苯胺
zbenhuan=苯环
zkutong=苦痛
zkudu=苦读
zkukou=苦口
zbaomi=苞米
zmuxu=苜蓿
zmiaochuang=苗床
zmiaomu=苗木
zfeiai=肺癌
zfeizang=肺脏
zfeipao=肺泡
zyaozhuan=肴馔
zyuchu=育雏
zyuyang=育秧
zyuzhong=育种
zyufei=育肥
zyucai=育才
zfeizhu=肥猪
zfeixiao=肥效
zsuran=肃然
zsufan=肃反
zyesu=耶稣
zluobu=罗布
zjinglun=经纶
zbanjiao=绊脚
zbanzhu=绊住
zzhongtian=终天
zzhongjiu=终久
zzhipin=织品
zzhiji=织机
zzhibu=织布
zxiqiao=细巧
zxiancai=线材
zxianxing=线形
zkongqin=空勤
zkongyu=空域
zkongdang=空挡
zkongfa=空乏
zbingzhi=秉直
zbingxing=秉性
zqiwang=祈望
zmabiao=码表
zmazi=码子
zkuangmai=矿脉
zkuangchuang=矿床
zkuangceng=矿层
zkuangkeng=矿坑
zkuangti=矿体
zkuangwu=矿务
zkuangchang=矿长
zfantu=矾土
zzhifu=知府
zzhixian=知县
zzhili=直隶
zzhichang=直肠
zhuazhi=画纸
zxianhui=现汇
zhuanxing=环形
zmuqun=牧群
zmuyang=牧羊
zmuye=牧业
zpashang=爬上
zyanliang=炎凉
zchuishi=炊事
zlutang=炉膛
zluwen=炉温
zluzha=炉渣
zluding=炉顶
zluchen=炉衬
zluhuo=炉火
zqianlan=浅蓝
zqianlv=浅绿
zqiantan=浅谈
zqianshuo=浅说
zqianlou=浅陋
zqianhong=浅红
zqianshui=浅水
zposhui=泼水
zluzhou=泸州
zzhusu=注塑
zniren=泥人
zbosi=波斯
zbofu=波幅
zbogu=波谷
zboer=波尔
zbochang=波长
zpaocha=泡茶
zpaoniu=泡妞
zyanbian=沿边
zyanr=沿儿
zzhanshi=沾湿
zzhanguang=沾光
zzhanshang=沾上
zyouguan=油罐
zyougao=油膏
zyoutong=油桶
zyoutong=油桐
zyoucha=油茶
zyouzha=油炸
zyoubeng=油泵
zhetun=河豚
zqiyi=歧义
zwuwei=武威
zwusong=武松
zwuguan=武官
zxinxi=欣悉
zxinyue=欣悦
zfengshu=枫树
zqiangtuo=枪托
zshuzhou=枢轴
zshuji=枢机
zzhizi=枝子
zguotang=果糖
zguoying=果蝇
zguodong=果冻
zguoren=果仁
zlinquan=林泉
zgouxian=构陷
zbanyan=板眼
zbanqiu=板球
zbanya=板鸭
zbanqiao=板桥
zbanfu=板斧
zbanshi=板式
zbanya=板牙
zbanshu=板书
zbanzi=板子
zsongxiang=松香
zsongguo=松果
zsongzhen=松针
zsongjiang=松江
zsongren=松仁
zsongxia=松下
zfuzui=服罪
zyiran=易燃
zhundao=昏倒
zhunhua=昏花
zmingbian=明辨
zminggou=明沟
zchanglong=昌隆
zangran=昂然
zangshou=昂首
zwangshi=旺市
zfuzheng=斧正
zzeyao=择要
zbogei=拨给
zbodong=拨动
zboda=拨打
zborong=拨冗
zningjin=拧紧
zyongjun=拥军
zzhaobing=招兵
zzhuoben=拙笨
zzhuobi=拙笔
zbaying=拔营
zbadiao=拔掉
zbacao=拔草
zbaqu=拔取
zbajie=拔节
zbaya=拔牙
zlaju=拉锯
zlading=拉丁
zchaizi=拆字
zfushi=拂拭
zminzui=抿嘴
zchousui=抽穗
zchouyan=抽咽
zmosha=抹煞
zbaowo=抱窝
zpiyue=披阅
zpijia=披甲
zguaishou=怪兽
zxingxian=性腺
zfenfen=忿忿
zjingliu=径流
zjingxiang=径向
zmisan=弥散
zmile=弥勒
zmituo=弥陀
zfeiye=废液
zfeiyou=废油
zdixin=底薪
zdiyun=底蕴
zdiban=底板
zwushan=巫山
zminjiang=岷江
zyueyang=岳阳
zlingnan=岭南
zyanyan=岩盐
zyanceng=岩层
zquyuan=屈原
zjushi=居士
zshencha=审察
zbaolan=宝蓝
zbaodian=宝殿
zbaota=宝塔
zbaozhu=宝珠
zbaojian=宝剑
zbaoji=宝鸡
zbaodao=宝岛
zbaoyu=宝玉
zbaoshan=宝山
zbaodao=宝刀
zyibin=宜宾
zdinghuo=定货
zxuejie=学界
zxueyi=学艺
zbaozi=孢子
zmengxia=孟夏
zmengqiu=孟秋
zshanshan=姗姗
zweimi=委靡
zgupo=姑婆
zbencuan=奔窜
zbenxie=奔泻
zbensang=奔丧
zfengsi=奉祀
zfenggong=奉公
zqiou=奇偶
zqili=奇丽
zyelan=夜阑
zyexi=夜袭
zbeike=备课
zbeigeng=备耕
zbeiqu=备取
zbeiwang=备忘
zbeikao=备考
zbeiyou=备有
zbeihao=备好
zchuilian=垂帘
zchuiti=垂体
zchuixia=垂下
zpiliao=坯料
zpibu=坯布
zganguo=坩埚
zpodu=坡度
zpodi=坡地
ztuban=图板
zguoqi=国企
zguofu=国父
zdongdong=咚咚
zgudong=咕咚
zzhouyu=咒语
zhechang=和畅
zhexian=和弦
zheqian=呵欠
zweir=味儿
zninan=呢喃
zcanzhuo=参酌
zcantou=参透
zwodao=卧倒
zwoshi=卧式
zzhuojue=卓绝
zzhuoshi=卓识
zduosui=剁碎
zkelu=刻录
zkehua=刻划
zshashi=刹时
zshazhu=刹住
zzhiheng=制衡
zzhiji=制剂
zzhifu=制伏
zguagong=刮宫
zpingzhao=凭照
zpingzhe=凭着
zjingli=净利
ztuchun=兔唇
zqiaolian=侨联
zceshi=侧室
zceji=侧记
zgonggao=供稿
zdongzu=侗族
zshihou=侍候
zkankan=侃侃
zjiaou=佳偶
zjiabin=佳宾
zjingzu=京族
zjinghu=京沪
zjixu=亟需
zshili=事例
zrutang=乳糖
zrusuan=乳酸
zruxian=乳腺
zruxiang=乳香
zrupin=乳品
zruchi=乳齿
zruji=乳剂
zruhua=乳化
zguaichuan=乖舛
zsangshen=丧身
zguitou=龟头
zmaizhong=麦种
zmaiya=麦芽
zmaitian=麦田
zmaijia=麦加
zjiwen=鸡瘟
zjilei=鸡肋
zjimao=鸡毛
zbochuan=驳船
zyindan=饮弹
zfanpu=饭铺
zfanpiao=饭票
zfanshi=饭食
zfanju=饭局
zfanzhuang=饭庄
zlushang=陆上
zfuyou=附有
zfuhui=附会
zfuji=附记
zfuxiao=附小
zfushang=附上
zzuzhi=阻滞
zzuzhi=阻值
zzuni=阻尼
zmenlei=闷雷
zjianmiao=间苗
zxianjing=闲静
zzhentong=针筒
zzhenbian=针砭
zzhenkong=针孔
zliang=里昂
zlinjia=邻家
zlincun=邻村
zlinxian=邻县
zyoudai=邮袋
zliangan=连杆
zweixian=违宪
zyuanyou=远游
zyuanmou=远谋
zfanqing=返青
zfanxiang=返乡
zjincheng=近程
zjinpang=近旁
zyundi=运抵
zyingzhe=迎着
zyinglai=迎来
zyingtou=迎头
zxuanyuan=轩辕
zxuanang=轩昂
zshenpang=身旁
zshenyun=身孕
zshenwang=身亡
zzoubian=走遍
zzoushou=走兽
zchichao=赤潮
zchibo=赤膊
zchifeng=赤峰
zchidou=赤豆
zcaibo=财帛
zdoukou=豆蔻
zdouzha=豆渣
zdouchi=豆豉
zdoujia=豆荚
zdoulei=豆类
zdouke=豆科
zdouya=豆芽
zdouhua=豆花
zdousha=豆沙
zdounai=豆奶
zyibi=译笔
zyima=译码
zyizhi=译制
zyiyuan=译员
zcisu=词素
zcixu=词序
zsuyuan=诉冤
zzhaqu=诈取
zzhasi=诈死
zpingpin=评聘
zjiaozhi=角质
zbuyi=补遗
zbuzhui=补缀
zbupiao=补票
zbuma=补码
zbubao=补报
zbuzheng=补正
zbuban=补办
zsulian=苏联
zcangcang=苍苍
zcanglong=苍龙
zhuacu=花簇
zhualei=花蕾
zhuarui=花蕊
zhuami=花蜜
zhuaqi=花旗
zjiecai=芥菜
zliangshan=良善
zliangyi=良医
zchangyan=肠炎
zchangyi=肠衣
zfangchui=纺锤
zwenshen=纹身
zzhiban=纸板
zzhitou=纸头
znaxin=纳新
znahui=纳贿
zshamao=纱帽
zchunjian=纯碱
zchunran=纯然
zchunmian=纯棉
zchunjin=纯金
zchunzhen=纯贞
zchunhua=纯化
zqiongqi=穷期
zqiongtu=穷途
zsinian=私念
zliaoshang=疗伤
znanying=男婴
zkuanglan=狂澜
zyoutai=犹太
zzhuangzhi=状纸
zlaomen=牢门
zlingxi=灵犀
zlingyi=灵异
zlingdan=灵丹
zcangzhou=沧州
zshami=沙弥
zqicha=沏茶
zchenxian=沉陷
zqideng=汽灯
zqiurao=求饶
zmeige=每隔
zjiandi=歼敌
zjianji=歼击
zjiquan=极圈
zlaichao=来潮
zlaifan=来犯
ztiaowen=条纹
ztiaoxing=条形
zshushou=束手
zxingshu=杏树
zxinghua=杏花
zlipeng=李鹏
zlikui=李逵
zshamu=杉木
zganjun=杆菌
zshige=时隔
zshitai=时态
zshiyi=时宜
zshixu=时序
zhanlu=旱路
zhanxiang=旱象
zhanyan=旱烟
zhantian=旱田
zniyi=拟议
zjuhui=拒贿
zjuchi=拒斥
zbaotong=报童
zbaozhang=报章
zbaoyan=报验
zbaoyuan=报怨
zhuxi=护膝
zhulu=护路
zhuchi=护持
zqiangtan=抢滩
zqiangyan=抢眼
zqiangzhong=抢种
zqiangyun=抢运
zqiangshou=抢收
zpaochu=抛出
zpaokai=抛开
zzhezhong=折衷
zkangbing=抗病
zkangdi=抗敌
zkangyuan=抗原
ztoudan=投弹
ztouji=投寄
zzhuabu=抓捕
zyizhi=抑止
zchaobao=抄报
zchaoshou=抄收
zjiyang=技痒
zezhu=扼住
zpibu=批捕
zfuyao=扶摇
zfushu=扶疏
zfuyang=扶养
zfuzheng=扶正
zraodong=扰动
zchekai=扯开
zbanku=扮酷
zbanzhuang=扮装
zniushang=扭伤
zjiedu=戒毒
zouqi=怄气
zkuaizhao=快照
zkuaidi=快递
zyouxin=忧心
zchongchong=忡忡
zzhishi=志士
ztante=忐忑
zxinghai=形骸
zzhangye=张掖
znongzhang=弄璋
znongwa=弄瓦
zxushu=序数
zbiyin=庇荫
zchakou=岔口
zniaosu=尿素
zsongdai=宋代
zxiaofu=孝服
ztuotie=妥帖
zmiaosuan=妙算
zmiaoyao=妙药
zmiaoshou=妙手
zduji=妒嫉
zshengpin=声频
zshengzhang=声障
zshengfu=声符
zshengna=声纳
zzhuide=坠地
zbazi=坝子
zjianlao=坚牢
zkuaijing=块茎
zkengmu=坑木
zkengkou=坑口
zhulun=囫囵
zwuhu=呜呼
zlili=呖呖
zouxin=呕心
zgaobai=告白
zdaiban=呆板
zchuizou=吹奏
zchuida=吹打
zxishi=吸湿
zzizi=吱吱
ztingzhen=听诊
zhanyun=含蕴
zhanhun=含混
zjunchen=君臣
zxianfen=县份
zxianban=县办
zluanhuang=卵黄
zluanxing=卵形
zlusu=卤素
zyike=医科
zyishi=医师
zyiyong=医用
zyishi=医士
zlaojun=劳军
zlizhi=励志
znuzui=努嘴
zzhuci=助词
zzhuli=助力
zliji=利己
zbaochuang=刨床
zchusu=初速
zdonghai=冻害
zlengpi=冷僻
zlengshi=冷食
zbingqi=兵器
zbingying=兵营
zbingjian=兵舰
zbingzhan=兵站
zbingjia=兵家
zbingbian=兵变
zbingzu=兵卒
zbingyuan=兵员
zbingquan=兵权
zbingshi=兵士
zbingding=兵丁
zduikuan=兑款
zmianzao=免遭
zmianyi=免役
zmianqu=免去
zmianyu=免予
zmianyu=免于
zkelong=克隆
zkeji=克己
zzuocao=作操
zfojia=佛家
zfofa=佛法
zfoshi=佛事
zfoguang=佛光
zfoshan=佛山
zyuhui=余辉
zyuque=余缺
zyuxian=余弦
zyuqie=余切
zhewei=何谓
zhexu=何许
zzuoliao=佐料
zsifu=伺服
zshenzhi=伸直
zshenchang=伸长
zbanwu=伴舞
zbanyin=伴音
zbanr=伴儿
zbolao=伯劳
zhengtong=亨通
zhengli=亨利
zluandan=乱弹
zluanma=乱码
zliri=丽日
zchuanlian=串连
zyanci=严辞
zliangce=两侧
zqiji=齐集
zyemian=页面
zyeyan=页岩
zyinshi=阴湿
zyinsi=阴私
zyangquan=阳泉
zfangshu=防暑
zchuangjin=闯进
zchuangguo=闯过
zchuangguan=闯关
zwenjin=问津
zbisuo=闭锁
zxingtai=邢台
zmaixiang=迈向
zmaichu=迈出
zguojing=过境
zguotang=过堂
zxunji=迅急
zxunchi=迅驰
zqianwang=迁往
zdadan=达旦
zzhenjie=贞洁
zxuchang=许昌
zjiangtang=讲堂
zjiangtan=讲坛
zguanzhan=观瞻
zguanyin=观音
zxihu=西湖
zxishai=西晒
zxishi=西施
zyichu=衣橱
zyidai=衣袋
zyiguan=衣冠
zyishi=衣饰
zxingji=行迹
zxueai=血癌
zxiehen=血痕
zxieniao=血尿
zchonghai=虫害
zchongzai=虫灾
zzhilan=芝兰
zmangxiao=芒硝
zzhoushan=舟山
zziyi=自缢
zzinei=自馁
zzixu=自叙
zzimian=自勉
zchenfu=臣服
zchenmin=臣民
zjijian=肌腱
zrouxian=肉馅
zroupiao=肉票
zrouzhi=肉质
zroudian=肉店
zrouzhi=肉汁
zrousi=肉丝
zroupian=肉片
zrouding=肉丁
zergou=耳垢
zerming=耳鸣
zerlun=耳轮
zerbian=耳边
zkaoji=考绩
zkaoshang=考上
zlaoyu=老妪
zlaobing=老兵
zyangqun=羊群
zyangpi=羊皮
zwangsu=网速
zwanglian=网恋
zwangzhuang=网状
zzhuyi=竹椅
zzhuye=竹叶
zbaishou=百兽
zdengzhan=灯盏
zdengxin=灯芯
zwusun=污损
zjianghuai=江淮
zjiangpan=江畔
zshantou=汕头
zdaohe=氘核
zbilu=毕露
zhuanyan=欢宴
zhuanyu=欢娱
zhuanxin=欢欣
zhuansheng=欢声
zquanzhang=权杖
zzapin=杂品
zjiyi=机翼
zjixiang=机箱
zjigeng=机耕
zjixing=机型
zjiyi=机宜
zjiyi=机译
zjiqiao=机巧
zjijing=机井
zyouzui=有罪
zyousun=有损
zyouwu=有误
zyouyu=有余
zqubing=曲柄
zqufu=曲阜
zgala=旮旯
zzaodao=早稻
zzaoxie=早泄
zshouhuo=收货
zkuoyin=扩音
zzhizhe=执着
zzhiye=执业
ztuoci=托辞
zchengyin=成荫
zchengxing=成型
zchenggui=成规
zchengxing=成形
zchengchong=成虫
zchihuan=弛缓
zyiti=异体
zyiji=异己
zyange=延搁
zyannian=延年
znianxin=年薪
znianyou=年幼
zgongxian=巩县
zxuncha=巡察
zxunhang=巡航
zxunzhen=巡诊
zxunfu=巡抚
zyaoshun=尧舜
zchenxiao=尘嚣
zjiansuan=尖酸
zxunwei=寻味
zxunzhi=寻址
zankang=安康
zanxiang=安详
zcunyi=存疑
zcunlan=存栏
zcunzhu=存贮
zzixing=字型
zjiaju=夹具
zduoduan=多端
zduozan=多咱
zzhuangjian=壮健
zzhuangmiao=壮苗
zzhuangzhi=壮志
zdimo=地膜
zdiman=地幔
zdiqin=地勤
zdipu=地铺
zdeyuan=地缘
zdiwen=地温
zdebao=地堡
zdiqi=地契
zdebo=地波
zdegou=地沟
zdegua=地瓜
zzaiwo=在握
zzaiye=在野
znannan=囡囡
zyinxun=因循
zyinxi=因袭
zhuikui=回馈
zhuitie=回帖
zhuihan=回函
ztutan=吐痰
ztuchu=吐出
zhouche=后撤
zhoutui=后腿
zmingmo=名模
zmingcha=名茶
zmingshi=名士
ztongzhuo=同桌
ztongzhi=同质
zdiaozhuang=吊装
zdiaosuo=吊索
zdiaogou=吊钩
zdiaogan=吊杆
zhezhao=合照
zheyi=合宜
zgeyi=各异
zchizhai=吃斋
zyasui=压碎
zhuashuo=华硕
zliezhong=劣种
zlieshen=劣绅
zchuanghen=创痕
zliubang=刘邦
zchongcheng=冲程
zchongji=冲剂
zbingshuang=冰霜
zbinggao=冰糕
zbingjiao=冰窖
zbingdai=冰袋
zbingdong=冰冻
znonggeng=农耕
znongdai=农贷
znongmu=农牧
znongji=农技
znongzhuang=农庄
znongyi=农艺
zjuncao=军操
zjunyuan=军援
zjunjie=军界
zjunken=军垦
zjunpin=军品
zjunshi=军士
zzaizhi=再植
zxingwei=兴味
zguanyu=关羽
zgongju=共聚
zgonge=共轭
zquanjing=全境
zquanpin=全拼
zquanma=全码
zquanjian=全歼
zguangyao=光耀
zguangpu=光谱
zguangdie=光碟
zguangban=光斑
zguangxu=光绪
zguangbo=光波
zguangqu=光驱
zzhaozhou=兆周
zchongtian=充填
zwazu=佤族
zweijun=伪军
zchuansong=传颂
zchuanshu=传述
zchuanbu=传布
zchuanyi=传艺
zweiji=伟绩
zsanxing=伞形
zsanbao=伞包
zhuiju=会聚
zhuiyan=会演
zhuizhi=会址
zyouyu=优育
zyoufu=优抚
zzhongshuo=众说
zxiuqi=休憩
zqihua=企划
zyangjiao=仰角
zyangzhi=仰止
zchanpo=产婆
zchanqian=产钳
zchanluan=产卵
zjiaogou=交媾
zjiaoyi=交谊
zyama=亚麻
zzhengyan=争艳
zqiaoshi=乔石
zlongtan=龙潭
zlongpao=龙袍
zlongxia=龙虾
zniaoming=鸟鸣
zniaoqiang=鸟枪
zbianyan=边沿
zzhagun=轧辊
zzhagang=轧钢
zyazhi=轧制
zyaji=轧机
zyiyuan=议院
zyizheng=议政
zyigou=议购
zyishi=议事
zyijue=议决
ztaojia=讨价
zjiufeng=纠风
zlisu=礼俗
zshibi=石壁
zshimo=石墨
zshila=石蜡
zshigu=石鼓
zshifeng=石缝
zshisun=石笋
zshizhu=石柱
zpizhi=皮质
zpijia=皮夹
zbailu=白露
zbailu=白鹭
zbaixiong=白熊
zbaizu=白族
zbaihua=白桦
zbaiyi=白蚁
zdianhan=电焊
zdianhe=电荷
zdianping=电瓶
zdianrong=电容
zdianzha=电闸
zdianma=电码
zdianshu=电枢
zdianhu=电弧
zshenao=申奥
zshenshuo=申说
zjiachun=甲醇
zjiawan=甲烷
zjiaji=甲基
zjiaben=甲苯
zjiachong=甲虫
zjiaji=甲级
zyongshan=用膳
zyongnao=用脑
zshengqi=生漆
zshengxi=生息
zgancao=甘草
zganquan=甘泉
zganyou=甘油
zganxiu=甘休
zxuanli=玄理
zxuanwu=玄武
zxuanhu=玄乎
zfankun=犯困
zfanxia=犯下
zfanshang=犯上
zmiejun=灭菌
zmieding=灭顶
zhanbao=汉堡
zhuifei=汇费
zhuicheng=汇成
zhuichu=汇出
zyongci=永磁
zyongle=永乐
zminpin=民品
zminzhai=民宅
zmuyang=母羊
zzhengxian=正弦
zbenxi=本溪
zbenbu=本埠
zbenxian=本县
zmoshao=末梢
zjiumao=旧貌
zdala=打蜡
zdalie=打猎
zdazhuang=打桩
zdadun=打盹
zbapi=扒皮
zbibai=必败
zyouya=幼芽
zyouti=幼体
zpinglu=平炉
zpingyi=平抑
zshuaige=帅哥
zbulei=布雷
zbuman=布满
zbudao=布道
zbudai=布袋
zbukong=布控
zbudian=布点
zbushi=布施
zbudian=布店
zbugu=布谷
zbufang=布防
zbuyi=布衣
zbushen=布什
zbuding=布丁
zshifu=市府
zjulang=巨浪
zjushi=巨石
zqiaogan=巧干
zzuojian=左键
zduijin=对襟
zduizhang=对仗
ztoucun=头寸
zhangshi=夯实
zwaiyan=外延
zchuxing=处刑
zchushi=处士
zshengdian=圣殿
zqiufang=囚房
zsinan=司南
zyemai=叶脉
zyerou=叶肉
zyoujian=右键
zshiji=史迹
zchizha=叱咤
ztaizhou=台州
zzhaohui=召回
zzhixiao=只消
zguyuan=古猿
zgumu=古墓
zguzheng=古筝
zfayang=发痒
zfatie=发帖
zfahan=发函
zlixing=厉行
zbanbi=半壁
zbantu=半途
zbanyin=半音
zbeijiang=北疆
zbeiwei=北魏
zbeifa=北伐
zbaopei=包赔
zjiagai=加盖
zjigu=击鼓
zjijian=击键
zchubang=出榜
zchutuo=出脱
zchulan=出栏
zchuhuo=出货
zchumiao=出苗
zchulu=出炉
zchubing=出兵
zchuhan=出汗
zaohen=凹痕
zaomian=凹面
ztulun=凸轮
ztuchu=凸出
zdongsun=冬笋
zdongmai=冬麦
zdongxian=冬闲
zdaike=代课
zxiantao=仙桃
zfuzi=付梓
zfuyin=付印
zfuyu=付与
zlefu=乐府
zzhuji=主祭
zdongguan=东莞
zbingwan=丙烷
zshizu=世族
zshitai=世态
zfengqin=风琴
zfengling=风铃
zfengliang=风凉
zduiqi=队旗
zduixing=队形
zchangdi=长笛
zchanglang=长廊
zchangqi=长崎
zchangbo=长波
zchangqu=长驱
zchangxing=长形
zchechuang=车窗
zcheling=车铃
zchechen=车臣
zbeilei=贝勒
zbeilei=贝类
zbeier=贝尔
zbeining=贝宁
zfuwen=讣闻
zjianli=见礼
zwangma=王码
zwangfei=王妃
zniuru=牛乳
zyayi=牙医
zhuobao=火暴
zhuoji=火鸡
zshuicao=水槽
zshuiwen=水温
zshuishe=水蛇
zshuizu=水族
zshuizhu=水柱
zqinang=气囊
zshizu=氏族
zbiyi=比翼
zbizhao=比照
zbisuo=比索
zbishi=比试
zbiwu=比武
zbilin=比邻
zwuyong=毋庸
zzhike=止渴
zzhike=止咳
zmutong=木桶
zmuji=木屐
zmushan=木栅
zmuer=木耳
zmulan=木兰
zyueqin=月琴
zyuewei=月尾
zrizhen=日臻
zwuxi=无锡
zwuyuan=无援
zwulv=无虑
zwuzu=无阻
zwubu=无补
zwuxu=无序
zwuyu=无余
zfangge=方格
zwenwu=文武
zzhiqu=支渠
zshoulei=手雷
zshoujin=手巾
zxinzhi=心智
zxinlv=心律
zxinfei=心肺
zxingan=心甘
zyinhang=引航
zkailian=开镰
zkaiyan=开颜
zkaihang=开航
zkaibiao=开标
zkaiwa=开挖
zbizhi=币制
zbadou=巴豆
zkongxi=孔隙
zkongdao=孔道
zkongjing=孔径
zfuxu=夫婿
ztianrang=天壤
ztianpeng=天棚
ztianma=天麻
ztianzhu=天竺
ztianfu=天府
ztianlun=天伦
zshuangbi=双臂
zshuangjian=双键
zshuangxi=双喜
zshuangpin=双拼
zshuangqiang=双抢
zwuyan=午宴
zshengxu=升序
zgouhun=勾魂
zgouxiao=勾销
zgoutong=勾通
zgoulian=勾连
zquanmian=劝勉
zqiege=切割
zqiewu=切勿
zfennie=分蘖
zfenbing=分兵
zxiongheng=凶横
zrongyu=冗余
zneizhi=内置
zneiku=内裤
zneima=内码
zneidi=内弟
zneier=内耳
zgongtang=公堂
zgongli=公厘
zgongdan=公担
zgongsi=公私
zyuanpei=元配
zcangxie=仓颉
zcangfang=仓房
zjiezhi=介质
zchoujia=仇家
zrende=仁德
zjingpen=井喷
zjingtian=井田
zhuliang=互谅
zhumian=互勉
zyunxiao=云霄
zyunshan=云杉
zyunmu=云母
zshuhan=书函
zweifu=为辅
zweihuan=为患
zweipan=为盼
zweili=为例
zweijia=为佳
zdancan=丹参
zdandong=丹东
zdanfeng=丹凤
zfengyu=丰裕
zfengrun=丰润
zzhongyong=中庸
zzhongwei=中尉
zzhonggeng=中耕
zzhuanji=专辑
zmahe=马赫
zmasai=马赛
zmabei=马背
zfeihuang=飞蝗
zfeie=飞蛾
zfeimo=飞沫
zfeichong=飞虫
zmenlang=门廊
zmenfa=门阀
zmenzhu=门柱
zmenjing=门径
zgongxing=弓形
zganqu=干渠
zgongfeng=工蜂
zgongpeng=工棚
zgongxiao=工效
zchuanju=川剧
zchuanjun=川军
zchuanbei=川贝
zshanbeng=山崩
zcunduan=寸断
zjiejue=孑孓
znvwa=女娲
zdazhai=大寨
ztuzu=土族
ztudui=土堆
zrenju=刃具
zwanfu=万福
zwanlong=万隆
zbogua=卜卦
zdaoren=刀刃
zdingwan=丁烷
zdingxi=丁烯
zyixi=乙烯
zyiben=乙苯
zyique=乙炔

