znrji=内燃机
zlhho=乱哄哄
zegsi=恩格斯
zngdi=尼古丁
zemsh=峨眉山
znmxi=匿名信
zaska=奥斯卡
zlsji=洛杉矶
zlsba=卢森堡
znssa=鸟兽散
zltwa=立陶宛
zltsh=路透社
zltpo=老太婆
zlybe=老一辈
zlyqu=连衣裙
zlyda=林荫道
zazbi=艾滋病
zezju=恶作剧
zrzni=孺子牛
zblju=八路军
zblqi=保龄球
zbldi=白兰地
zblch=碧螺春
zblzh=避雷针
zbdfe=贝多芬
zbmma=白茫茫
zbqen=白求恩
zbsdu=波士顿
zbtti=扁桃体
zbxga=不锈钢
zbxbi=败血病
zbygu=殡仪馆
zbych=百叶窗
zctfe=穿堂风
zcwhu=筹委会
zcwyu=乘务员
zcxfa=吃闲饭
zcxxi=穿小鞋
zcyyu=炒鱿鱼
zcyqi=吃一堑
zdlzh=顶梁柱
zdlhe=度量衡
zdfgu=电饭锅
zdfba=电饭煲
zdhsu=导火索
zdgch=胆固醇
zdjch=打基础
zdjpa=挡箭牌
zdjsh=垫脚石
zdthu=洞庭湖
zdzco=倒栽葱
zhebi=哈尔滨
zheme=荷尔蒙
zflbi=菲律宾
zhntu=混凝土
zhlyi=海洛因
zhlwu=好莱坞
zflxi=法兰西
zhlla=火辣辣
zhlli=灰溜溜
zhbgo=哈巴狗
zfbzh=犯不着
zhddu=好端端
zfmtu=飞毛腿
zhsdu=华盛顿
zhsfu=护身符
zfsli=分水岭
zhsla=黄鼠狼
zfsxu=仿生学
zhtto=红彤彤
zhwli=婚外恋
zfxdi=发祥地
zhxzi=黑匣子
zhyzh=后遗症
zglli=孤零零
zgjji=公积金
zgmzh=擀面杖
zgttu=光秃秃
zgtzi=狗腿子
zgzsh=刽子手
zjlbu=俱乐部
zjlji=嘉陵江
zjbpe=聚宝盆
zjddi=娇滴滴
zjgsh=井冈山
zjgwe=甲骨文
zjgzh=紧箍咒
zjgde=聚光灯
zjgji=聚光镜
zjjzh=佼佼者
zjsfa=夹生饭
zjtla=景泰蓝
zjwji=鸡尾酒
zjxxi=假惺惺
zjywa=局域网
zjzmi=江泽民
zjzxi=甲状腺
zkbgu=看不惯
zkdda=空荡荡
zkgbo=克格勃
zkssu=抗生素
zksxi=可塑性
zkxta=口香糖
zkxse=苦行僧
zmlso=马拉松
zmnhe=慕尼黑
zmnyi=木乃伊
zmrji=麦乳精
zmrro=毛茸茸
zmdha=马大哈
zmhzh=迷魂阵
zmhlu=闷葫芦
zmkfe=麦克风
zmmsh=棉毛衫
zmmyu=毛毛雨
zmqzu=马前卒
zmsli=穆斯林
zmtyi=猫头鹰
zmttu=慢吞吞
zmxgu=毛细管
zmzzi=美滋滋
zpddu=胖墩墩
zpddu=胖嘟嘟
zphhu=胖乎乎
zpgyi=蒲公英
zpthu=破天荒
zpwxi=抛物线
zqbte=丘比特
zqgda=穷光蛋
zqgzi=枪杆子
zqkli=巧克力
zqsji=全世界
zqshu=秦始皇
zqtca=墙头草
zqzga=敲竹杠
zslli=酸溜溜
zsbzh=殊不知
zsbwu=桑巴舞
zscji=杀虫剂
zshji=松花江
zsmxi=三门峡
zssli=十三陵
zswmo=视网膜
zswch=司务长
zsxsh=省辖市
zszqi=水蒸气
ztrsu=托儿所
ztnbi=糖尿病
ztlfa=吐鲁番
ztlsi=托拉斯
ztkla=土坷垃
ztyxi=童养媳
ztzya=替罪羊
zwldo=窝里斗
zwbxi=五边形
zwhto=万花筒
zwsji=威士忌
zwtba=乌托邦
zwxpu=五线谱
zwyna=维也纳
zwyji=望远镜
zwzzh=文绉绉
zxlyi=夏令营
zxcqi=吸尘器
zxhsh=西红柿
zxfga=洗发膏
zxjpo=新加坡
zxpsh=嬉皮士
zxsji=新世界
zxtle=希特勒
zxwyi=夏威夷
zylzi=一揽子
zylgu=易拉罐
zylji=鸭绿江
zylsu=叶绿素
zylya=一溜烟
zyhyu=颐和园
zyhch=萤火虫
zyfzi=遗腹子
zypyi=硬碰硬
zyqsh=摇钱树
zysla=伊斯兰
zywfe=一窝蜂
zywfu=燕尾服
zyxhu=一席话
zyxcu=一小撮
zyyta=一言堂
zyzji=银质奖
zyzbi=圆珠笔
zzlsh=蒸馏水
zzgli=诸葛亮
zzkli=逐客令
zzsme=真善美
zztqi=助听器
zzwxi=子午线
zzxji=助学金
zzymi=座右铭
zpzhu=攀枝花
znhde=霓虹灯
zlbne=黎巴嫩
zmlge=摩洛哥
zmnge=摩纳哥
zmxge=墨西哥
zpyhu=鄱阳湖
zsllu=赛璐珞
zjyzh=简言之
zdwde=碘钨灯
zclda=催泪弹
zzjch=紫禁城
zzlla=紫罗兰
zybba=硬梆梆
zwghu=温哥华
zzhgu=最惠国
zfsto=富士通
zkmlo=喀麦隆
zhhlo=黄鹤楼
zhlme=黄粱梦
zljta=领奖台
zelch=鄂伦春
zsqma=萨其马
zsksi=萨克斯
zwwer=维吾尔
ztzzi=甜滋滋
zzbji=猪八戒
zfdga=梵蒂冈
zyzsh=鸭嘴兽
zgjsu=高加索
zqtji=钱塘江
zgdji=赶得及
znmya=脑膜炎
zydsu=胰岛素
zqhda=秦皇岛
zaela=爱尔兰
zstna=桑塔纳
zhgsu=核苷酸
ztlzi=捅娄子
zxszh=夏时制
zymyu=圆明园
zglbu=哥伦布
zspqi=适配器
zmhta=迷魂汤
zhjta=胡锦涛
ztnsi=突尼斯
zcsji=穿山甲
zfryu=疯人院
zjpzh=柬埔寨
zysho=映山红
zhske=哈萨克
zhnzu=哈尼族
zbyfu=饱眼福
zdggu=顶呱呱
zjjzh=金戒指
zjsho=金丝猴
zyjxi=郁金香
zbxzh=败血症
zfhli=肺活量
zlmsh=罗曼史
zclfa=炒冷饭
zsjyo=松节油
zjmsi=佳木斯
zmdla=麦当劳
zalqi=阿联酋
zafha=阿富汗
zagti=阿根廷
zablu=阿波罗
zlgdu=连锅端
zslsh=苏黎世
zswai=苏维埃
zkjsu=抗菌素
zsqli=宋庆龄
zbgch=兵工厂
zgllv=伽利略
zgsyi=观世音
zrzci=肉中刺
zbmda=百慕大
zbbxi=百宝箱
zbjsu=毕加索
zyze=扬子鳄
zxyji=巡洋舰
zaqr=安琪儿
zdnhe=多瑙河
zgyna=圭亚那
zhxzh=回形针
ztwsu=同位素
zjbti=吉布提
zhlge=华罗庚
zxyli=匈牙利
zbjli=冰激凌
zxsdu=休斯敦
zfeji=伏尔加
zymr=伊妹儿
zsbqi=示波器
zbmme=白蒙蒙
zbnzh=白内障
zfbsh=犯不上
zdxzh=打雪仗
zdzqi=打砸抢
zshsu=四环素
zkrxi=可燃性
zlgqi=卢沟桥
zcczi=出岔子
zqjer=丘吉尔
zfyji=风油精
zshzh=水浒传
zmmch=毛毛虫
zblgu=巴拉圭
zlhca=六合彩
zwlgu=乌拉圭
zwkla=乌克兰
zwgda=乌干达
zddhe=丹顶鹤
zmlsh=马铃薯

